id,class,name,h27,h22,inc,inc_rate,area,density,family_h27,family_h22,family_inc,family_rate
01100,1,札幌市,1952356,1913545,38811,2.0282251005,1121.26,1741.2,921837,885848,35989,4.0626608628
01101,0,札幌市 中央区,237627,220189,17438,7.9195600144,46.42,5119.1,132006,120741,11265,9.329887942
01102,0,札幌市 北区,285321,278781,6540,2.3459274484,63.57,4488.3,133662,127440,6222,4.8822975518
01103,0,札幌市 東区,261912,255873,6039,2.3601552333,56.97,4597.4,124425,118939,5486,4.6124483979
01104,0,札幌市 白石区,209584,204259,5325,2.60698427,34.47,6080.2,104608,100444,4164,4.1455935646
01105,0,札幌市 豊平区,218652,212118,6534,3.0803609312,46.23,4729.7,110171,107179,2992,2.7915916364
01106,0,札幌市 南区,141190,146341,-5151,-3.5198611462,657.48,214.7,61291,62776,-1485,-2.3655537148
01107,0,札幌市 西区,213578,211229,2349,1.112063211,75.1,2843.9,97750,96421,1329,1.3783304467
01108,0,札幌市 厚別区,127767,128492,-725,-0.5642374623,24.38,5240.6,55585,54099,1486,2.7468160225
01109,0,札幌市 手稲区,140999,139644,1355,0.9703245395,56.77,2483.7,57333,55050,2283,4.1471389646
01110,0,札幌市 清田区,115726,116619,-893,-0.7657414315,59.87,1933,45006,42759,2247,5.2550340279
01202,2,函館市,265979,279127,-13148,-4.710400642,677.86,392.4,123950,126180,-2230,-1.7673165319
01203,2,小樽市,121924,131928,-10004,-7.5829240192,243.83,500,55466,57711,-2245,-3.8900729497
01204,2,旭川市,339605,347095,-7490,-2.1579106585,747.66,454.2,155747,154393,1354,0.8769827648
01205,2,室蘭市,88564,94535,-5971,-6.3161791929,80.88,1095,43616,45029,-1413,-3.1379777477
01206,2,釧路市,174742,181169,-6427,-3.5475164073,1362.92,128.2,82078,81015,1063,1.312102697
01207,2,帯広市,169327,168057,1270,0.7556959841,619.34,273.4,77707,75474,2233,2.9586347616
01208,2,北見市,121226,125689,-4463,-3.550827837,1427.41,84.9,56202,56012,190,0.3392130258
01209,2,夕張市,8843,10922,-2079,-19.0349752793,763.07,11.6,4539,5558,-1019,-18.3339330694
01210,2,岩見沢市,84499,90145,-5646,-6.2632425537,481.02,175.7,36155,36723,-568,-1.546714593
01211,2,網走市,39077,40998,-1921,-4.6855944192,471,83,18035,18112,-77,-0.4251325088
01212,2,留萌市,22221,24457,-2236,-9.1425767674,297.83,74.6,10402,11044,-642,-5.8131111916
01213,2,苫小牧市,172737,173320,-583,-0.3363720286,561.57,307.6,78298,76289,2009,2.6334071753
01214,2,稚内市,36380,39595,-3215,-8.1197120849,761.47,47.8,16486,17343,-857,-4.9414749467
01215,2,美唄市,23035,26034,-2999,-11.5195513559,277.69,83,10173,10992,-819,-7.4508733624
01216,2,芦別市,14676,16628,-1952,-11.7392350253,865.04,17,6862,7526,-664,-8.8227478076
01217,2,江別市,120636,123722,-3086,-2.494301741,187.38,643.8,51983,51170,813,1.5888215751
01218,2,赤平市,11105,12637,-1532,-12.1231304898,129.88,85.5,4980,5585,-605,-10.8325872874
01219,2,紋別市,23109,24750,-1641,-6.6303030303,830.78,27.8,11127,11390,-263,-2.3090430202
01220,2,士別市,19914,21787,-1873,-8.5968696929,1119.22,17.8,8650,9100,-450,-4.9450549451
01221,2,名寄市,29048,30591,-1543,-5.0439671799,535.2,54.3,13086,13348,-262,-1.962840875
01222,2,三笠市,9076,10221,-1145,-11.2024263771,302.52,30,4254,4776,-522,-10.9296482412
01223,2,根室市,26917,29201,-2284,-7.8216499435,506.25,65.4,11383,11897,-514,-4.3204169118
01224,2,千歳市,95648,93604,2044,2.1836673646,594.5,160.9,40638,38541,2097,5.4409589787
01225,2,滝川市,41192,43170,-1978,-4.5818855687,115.9,355.4,18651,18947,-296,-1.5622525994
01226,2,砂川市,17694,19056,-1362,-7.1473551637,78.68,224.9,7858,8415,-557,-6.6191325015
01227,2,歌志内市,3585,4387,-802,-18.2812856166,55.95,64.1,1665,2000,-335,-16.75
01228,2,深川市,21909,23709,-1800,-7.5920536505,529.42,41.4,9669,10100,-431,-4.2673267327
01229,2,富良野市,22936,24259,-1323,-5.4536460695,600.71,38.2,9929,10074,-145,-1.4393488187
01230,2,登別市,49625,51526,-1901,-3.6893995265,212.21,233.8,21681,21717,-36,-0.1657687526
01231,2,恵庭市,69702,69384,318,0.4583189208,294.65,236.6,28846,27634,1212,4.3859014258
01233,2,伊達市,34995,36278,-1283,-3.5365786427,444.21,78.8,15054,15287,-233,-1.5241708641
01234,2,北広島市,59064,60353,-1289,-2.1357678989,119.05,496.1,23551,22991,560,2.4357357227
01235,2,石狩市,57436,59449,-2013,-3.386095645,722.42,79.5,22632,22603,29,0.1283015529
01236,2,北斗市,46390,48032,-1642,-3.4185542971,397.44,116.7,18508,18412,96,0.5213990876
01303,3,当別町,17278,18766,-1488,-7.9292337206,422.86,40.9,7327,7400,-73,-0.9864864865
01304,3,新篠津村,3329,3515,-186,-5.2916073969,78.04,42.7,1070,1086,-16,-1.4732965009
01331,3,松前町,7337,8748,-1411,-16.1294010059,293.25,25,3571,3959,-388,-9.8004546603
01332,3,福島町,4422,5114,-692,-13.5314822057,187.28,23.6,2039,2194,-155,-7.064721969
01333,3,知内町,4653,5074,-421,-8.297201419,196.75,23.6,2003,2009,-6,-0.2986560478
01334,3,木古内町,4547,5341,-794,-14.8661299382,221.87,20.5,2140,2317,-177,-7.639188606
01337,3,七飯町,28120,28463,-343,-1.205073253,216.75,129.7,11141,10891,250,2.2954733266
01343,3,鹿部町,4226,4767,-541,-11.3488567233,110.64,38.2,1660,1675,-15,-0.8955223881
01345,3,森町,15946,17859,-1913,-10.7116859847,368.79,43.2,6628,7103,-475,-6.6873152189
01346,3,八雲町,17252,18896,-1644,-8.700254022,956.07,18,7523,7892,-369,-4.6756208819
01347,3,長万部町,5926,6386,-460,-7.203257125,310.76,19.1,2685,2847,-162,-5.6902002107
01361,3,江差町,8248,9004,-756,-8.3962683252,109.53,75.3,3752,3968,-216,-5.4435483871
01362,3,上ノ国町,4876,5428,-552,-10.1694915254,547.71,8.9,2173,2307,-134,-5.8084091894
01363,3,厚沢部町,4049,4409,-360,-8.1651168065,460.58,8.8,1765,1868,-103,-5.5139186296
01364,3,乙部町,3906,4408,-502,-11.388384755,162.59,24,1729,1863,-134,-7.1926999463
01367,3,奥尻町,2690,3033,-343,-11.3089350478,142.97,18.8,1270,1364,-94,-6.8914956012
01370,3,今金町,5628,6186,-558,-9.0203685742,568.25,9.9,2280,2388,-108,-4.5226130653
01371,3,せたな町,8473,9590,-1117,-11.6475495308,638.69,13.3,3862,4169,-307,-7.3638762293
01391,3,島牧村,1499,1781,-282,-15.8338012353,437.18,3.4,661,742,-81,-10.9164420485
01392,3,寿都町,3137,3443,-306,-8.887598025,95.24,32.9,1420,1536,-116,-7.5520833333
01393,3,黒松内町,3082,3250,-168,-5.1692307692,345.65,8.9,1336,1353,-17,-1.2564671101
01394,3,蘭越町,4843,5292,-449,-8.4845049131,449.78,10.8,2086,2129,-43,-2.0197275716
01395,3,ニセコ町,4958,4823,135,2.7990877047,197.13,25.2,2274,2054,220,10.7108081792
01396,3,真狩村,2103,2189,-86,-3.928734582,114.25,18.4,855,867,-12,-1.384083045
01397,3,留寿都村,1907,2034,-127,-6.2438544739,119.84,15.9,915,883,32,3.62400906
01398,3,喜茂別町,2294,2490,-196,-7.8714859438,189.41,12.1,1123,1207,-84,-6.9594034797
01399,3,京極町,3187,3811,-624,-16.3736552086,231.49,13.8,1281,1740,-459,-26.3793103448
01400,3,倶知安町,15018,15568,-550,-3.5328879753,261.34,57.5,6974,7102,-128,-1.8023092087
01401,3,共和町,6224,6428,-204,-3.1736154325,304.91,20.4,2854,2698,156,5.7820607858
01402,3,岩内町,13042,14451,-1409,-9.7501902982,70.6,184.7,6228,6555,-327,-4.9885583524
01403,3,泊村,1771,1883,-112,-5.9479553903,82.28,21.5,886,855,31,3.6257309942
01404,3,神恵内村,1004,1122,-118,-10.5169340463,147.8,6.8,434,473,-39,-8.245243129
01405,3,積丹町,2115,2516,-401,-15.9379968203,238.14,8.9,994,1175,-181,-15.4042553191
01406,3,古平町,3188,3611,-423,-11.714206591,188.36,16.9,1446,1588,-142,-8.9420654912
01407,3,仁木町,3498,3800,-302,-7.9473684211,167.96,20.8,1480,1493,-13,-0.8707300737
01408,3,余市町,19607,21258,-1651,-7.7664879104,140.59,139.5,8769,9051,-282,-3.1156778257
01409,3,赤井川村,1121,1262,-141,-11.1727416799,280.09,4,534,619,-85,-13.731825525
01423,3,南幌町,7927,8778,-851,-9.6946912736,81.36,97.4,2973,3068,-95,-3.0964797914
01424,3,奈井江町,5674,6194,-520,-8.3952211818,88.19,64.3,2466,2622,-156,-5.9496567506
01425,3,上砂川町,3479,4086,-607,-14.8556045032,39.98,87,1744,1954,-210,-10.747185261
01427,3,由仁町,5314,5896,-582,-9.8710990502,133.74,39.7,2149,2258,-109,-4.8272807795
01428,3,長沼町,11076,11691,-615,-5.2604567616,168.52,65.7,4257,4324,-67,-1.5494912118
01429,3,栗山町,12344,13340,-996,-7.4662668666,203.93,60.5,5186,5484,-298,-5.4339897885
01430,3,月形町,4577,4859,-282,-5.8036633052,150.4,30.4,1466,1511,-45,-2.9781601588
01431,3,浦臼町,1985,2206,-221,-10.0181323663,101.83,19.5,850,920,-70,-7.6086956522
01432,3,新十津川町,6831,7249,-418,-5.7663125948,495.47,13.8,2570,2694,-124,-4.6028210839
01433,3,妹背牛町,3091,3462,-371,-10.7163489313,48.64,63.5,1269,1356,-87,-6.4159292035
01434,3,秩父別町,2513,2730,-217,-7.9487179487,47.18,53.3,1017,1052,-35,-3.3269961977
01436,3,雨竜町,2749,3049,-300,-9.839291571,191.15,14.4,1005,1067,-62,-5.8106841612
01437,3,北竜町,1981,2193,-212,-9.667122663,158.7,12.5,782,805,-23,-2.8571428571
01438,3,沼田町,3181,3612,-431,-11.9324473976,283.35,11.2,1333,1437,-104,-7.2372999304
01452,3,鷹栖町,7018,7345,-327,-4.4520081688,139.42,50.3,2717,2732,-15,-0.5490483163
01453,3,東神楽町,10233,9292,941,10.12699096,68.5,149.4,3657,3290,367,11.1550151976
01454,3,当麻町,6689,7087,-398,-5.6159164668,204.9,32.6,2698,2743,-45,-1.6405395552
01455,3,比布町,3777,4042,-265,-6.5561603167,86.9,43.5,1586,1639,-53,-3.2336790726
01456,3,愛別町,2976,3328,-352,-10.5769230769,250.13,11.9,1305,1332,-27,-2.027027027
01457,3,上川町,4044,4532,-488,-10.7678729038,1049.47,3.9,2102,2303,-201,-8.7277464177
01458,3,東川町,8111,7859,252,3.2065148238,247.3,32.8,3148,2983,165,5.5313442843
01459,3,美瑛町,10292,10956,-664,-6.0606060606,676.78,15.2,4288,4301,-13,-0.3022552895
01460,3,上富良野町,10826,11545,-719,-6.2278042443,237.1,45.7,4363,4416,-53,-1.2001811594
01461,3,中富良野町,5069,5477,-408,-7.4493335768,108.65,46.7,2025,2015,10,0.4962779156
01462,3,南富良野町,2555,2814,-259,-9.2039800995,665.54,3.8,1132,1199,-67,-5.5879899917
01463,3,占冠村,1211,1394,-183,-13.1276901004,571.41,2.1,704,794,-90,-11.3350125945
01464,3,和寒町,3596,3832,-236,-6.1586638831,225.11,16,1533,1601,-68,-4.2473454091
01465,3,剣淵町,3228,3565,-337,-9.4530154278,130.99,24.6,1330,1329,1,0.0752445448
01468,3,下川町,3547,3775,-228,-6.0397350993,644.2,5.5,1674,1685,-11,-0.6528189911
01469,3,美深町,4659,5178,-519,-10.023174971,672.09,6.9,2041,2194,-153,-6.9735642662
01470,3,音威子府村,832,995,-163,-16.3819095477,275.63,3,405,486,-81,-16.6666666667
01471,3,中川町,1767,1907,-140,-7.3413738857,594.74,3,897,926,-29,-3.13174946
01472,3,幌加内町,1525,1710,-185,-10.8187134503,767.04,2,690,780,-90,-11.5384615385
01481,3,増毛町,4497,5078,-581,-11.4415124065,369.71,12.2,2051,2208,-157,-7.1105072464
01482,3,小平町,3336,3717,-381,-10.2502017756,627.22,5.3,1406,1512,-106,-7.0105820106
01483,3,苫前町,3265,3656,-391,-10.6947483589,454.6,7.2,1420,1520,-100,-6.5789473684
01484,3,羽幌町,7327,7964,-637,-7.9984932195,472.65,15.5,3367,3534,-167,-4.7255234861
01485,3,初山別村,1217,1369,-152,-11.1029948868,279.51,4.4,537,579,-42,-7.2538860104
01486,3,遠別町,2806,3084,-278,-9.0142671855,590.8,4.7,1225,1304,-79,-6.0582822086
01487,3,天塩町,3243,3780,-537,-14.2063492063,353.56,9.2,1502,1619,-117,-7.2266831377
01511,3,猿払村,2684,2825,-141,-4.9911504425,589.97,4.5,1174,1220,-46,-3.7704918033
01512,3,浜頓別町,3881,4168,-287,-6.8857965451,401.64,9.7,1845,1868,-23,-1.2312633833
01513,3,中頓別町,1757,1974,-217,-10.9929078014,398.51,4.4,775,817,-42,-5.1407588739
01514,3,枝幸町,8437,9125,-688,-7.5397260274,1115.93,7.6,3772,3952,-180,-4.5546558704
01516,3,豊富町,4054,4378,-324,-7.4006395614,520.69,7.8,1782,1854,-72,-3.8834951456
01517,3,礼文町,2773,3078,-305,-9.9090318389,81.64,34,1353,1445,-92,-6.3667820069
01518,3,利尻町,2303,2590,-287,-11.0810810811,76.51,30.1,1154,1313,-159,-12.1096725057
01519,3,利尻富士町,2787,3037,-250,-8.231807705,105.61,26.4,1264,1363,-99,-7.2633895818
01520,3,幌延町,2447,2677,-230,-8.5917071349,574.1,4.3,1138,1224,-86,-7.0261437908
01543,3,美幌町,20296,21575,-1279,-5.9281575898,438.41,46.3,8626,8725,-99,-1.1346704871
01544,3,津別町,5008,5646,-638,-11.3000354233,716.8,7,2231,2358,-127,-5.3859202714
01545,3,斜里町,12231,13045,-814,-6.2399386738,737.12,16.6,5547,5759,-212,-3.6811946518
01546,3,清里町,4221,4551,-330,-7.2511535926,402.76,10.5,1671,1784,-113,-6.3340807175
01547,3,小清水町,5085,5358,-273,-5.0951847704,286.89,17.7,2033,2069,-36,-1.7399710005
01549,3,訓子府町,5100,5435,-335,-6.1637534499,190.95,26.7,1910,1956,-46,-2.3517382413
01550,3,置戸町,3092,3428,-336,-9.8016336056,527.27,5.9,1304,1367,-63,-4.608632041
01552,3,佐呂間町,5362,5892,-530,-8.9952477936,404.94,13.2,2311,2415,-104,-4.3064182195
01555,3,遠軽町,20873,22265,-1392,-6.2519649674,1332.45,15.7,9278,9617,-339,-3.5250077987
01559,3,湧別町,9231,10041,-810,-8.066925605,505.79,18.3,3861,4010,-149,-3.7157107232
01560,3,滝上町,2721,3028,-307,-10.1387054161,766.89,3.5,1295,1376,-81,-5.886627907
01561,3,興部町,3909,4301,-392,-9.1141594978,362.54,10.8,1757,1877,-120,-6.3931806074
01562,3,西興部村,1116,1135,-19,-1.6740088106,308.08,3.6,501,516,-15,-2.9069767442
01563,3,雄武町,4525,4939,-414,-8.3822636161,636.86,7.1,2062,2228,-166,-7.4506283662
01564,3,大空町,7360,7933,-573,-7.2229925627,343.66,21.4,2874,2967,-93,-3.134479272
01571,3,豊浦町,4291,4528,-237,-5.2340989399,233.57,18.4,1973,1944,29,1.4917695473
01575,3,壮瞥町,2922,3232,-310,-9.5915841584,205.01,14.3,1168,1226,-58,-4.7308319739
01578,3,白老町,17740,19376,-1636,-8.4434351775,425.64,41.7,7955,8412,-457,-5.4327151688
01581,3,厚真町,4838,4890,-52,-1.063394683,404.61,12,2126,1972,154,7.8093306288
01584,3,洞爺湖町,9299,10132,-833,-8.2214765101,180.81,51.4,4240,4461,-221,-4.954046178
01585,3,安平町,8148,8726,-578,-6.6238826496,237.16,34.4,3651,3753,-102,-2.7178257394
01586,3,むかわ町,8596,9746,-1150,-11.7997127026,711.36,12.1,3784,4127,-343,-8.3111218803
01601,3,日高町,12378,13615,-1237,-9.0855673889,992.11,12.5,5781,6064,-283,-4.6668865435
01602,3,平取町,5315,5596,-281,-5.0214438885,743.09,7.2,2373,2412,-39,-1.6169154229
01604,3,新冠町,5592,5775,-183,-3.1688311688,585.81,9.5,2405,2388,17,0.7118927973
01607,3,浦河町,13075,14389,-1314,-9.1319758149,694.26,18.8,6178,6358,-180,-2.8310789556
01608,3,様似町,4518,5114,-596,-11.6542823621,364.3,12.4,2044,2206,-162,-7.3436083409
01609,3,えりも町,4906,5413,-507,-9.3663402919,284,17.3,1929,2036,-107,-5.2554027505
01610,3,新ひだか町,23231,25419,-2188,-8.6077343719,1147.55,20.2,10443,11015,-572,-5.1929187472
01631,3,音更町,44807,45085,-278,-0.6166130642,466.02,96.1,18019,17660,359,2.0328425821
01632,3,士幌町,6132,6416,-284,-4.4264339152,259.19,23.7,2479,2458,21,0.8543531326
01633,3,上士幌町,4765,5080,-315,-6.2007874016,694.23,6.9,2177,2225,-48,-2.1573033708
01634,3,鹿追町,5542,5702,-160,-2.8060329709,402.88,13.8,2258,2270,-12,-0.5286343612
01635,3,新得町,6288,6653,-365,-5.486246806,1063.83,5.9,3043,3106,-63,-2.0283322601
01636,3,清水町,9599,9961,-362,-3.6341732758,402.25,23.9,4131,4097,34,0.8298755187
01637,3,芽室町,18484,18905,-421,-2.2269240942,513.76,36,7169,7089,80,1.1285089575
01638,3,中札内村,3966,4006,-40,-0.9985022466,292.58,13.6,1609,1570,39,2.4840764331
01639,3,更別村,3185,3391,-206,-6.0749041581,176.9,18,1239,1274,-35,-2.7472527473
01641,3,大樹町,5738,5977,-239,-3.9986615359,815.68,7,2534,2533,1,0.0394788788
01642,3,広尾町,7030,7881,-851,-10.7981220657,596.54,11.8,3157,3294,-137,-4.1590771099
01643,3,幕別町,26760,26547,213,0.8023505481,477.64,56,10944,10359,585,5.6472632493
01644,3,池田町,6882,7527,-645,-8.5691510562,371.79,18.5,3044,3189,-145,-4.5468798997
01645,3,豊頃町,3182,3394,-212,-6.2463170301,536.71,5.9,1362,1376,-14,-1.0174418605
01646,3,本別町,7358,8275,-917,-11.081570997,391.91,18.8,3260,3482,-222,-6.3756461804
01647,3,足寄町,6990,7630,-640,-8.3879423329,1408.04,5,3179,3348,-169,-5.0477897252
01648,3,陸別町,2482,2650,-168,-6.3396226415,608.9,4.1,1128,1135,-7,-0.6167400881
01649,3,浦幌町,4919,5460,-541,-9.9084249084,729.85,6.7,2086,2216,-130,-5.8664259928
01661,3,釧路町,19833,20526,-693,-3.3762057878,252.66,78.5,8119,8098,21,0.2593232897
01662,3,厚岸町,9778,10630,-852,-8.0150517404,739.26,13.2,4115,4278,-163,-3.8101916784
01663,3,浜中町,6061,6511,-450,-6.9113807403,423.63,14.3,2325,2344,-19,-0.8105802048
01664,3,標茶町,7742,8285,-543,-6.554013277,1099.37,7,3281,3365,-84,-2.4962852897
01665,3,弟子屈町,7758,8278,-520,-6.2817105581,774.33,10,3509,3632,-123,-3.3865638767
01667,3,鶴居村,2534,2627,-93,-3.5401598782,571.8,4.4,1026,979,47,4.8008171604
01668,3,白糠町,8068,9294,-1226,-13.1913062191,773.53,10.4,3609,3896,-287,-7.3665297741
01691,3,別海町,15273,15855,-582,-3.6707663198,1319.63,11.6,5997,5862,135,2.3029682702
01692,3,中標津町,23774,23982,-208,-0.8673171545,684.87,34.7,10437,10084,353,3.500595002
01693,3,標津町,5242,5646,-404,-7.1555083245,624.68,8.4,2169,2235,-66,-2.9530201342
01694,3,羅臼町,5415,5885,-470,-7.9864061172,397.72,13.6,2101,2177,-76,-3.4910427193
02201,2,青森市,287648,299520,-11872,-3.9636752137,824.61,348.8,118234,119413,-1179,-0.9873296877
02202,2,弘前市,177411,183473,-6062,-3.3040283856,524.2,338.4,71152,70142,1010,1.4399361296
02203,2,八戸市,231257,237615,-6358,-2.6757570019,305.54,756.9,93750,91917,1833,1.9941904109
02204,2,黒石市,34284,36132,-1848,-5.1145798738,217.05,158,11770,11794,-24,-0.2034933017
02205,2,五所川原市,55181,58421,-3240,-5.5459509423,404.18,136.5,21143,21277,-134,-0.629788034
02206,2,十和田市,63429,66110,-2681,-4.055362275,725.65,87.4,25487,25554,-67,-0.2621898724
02207,2,三沢市,40196,41258,-1062,-2.5740462456,119.87,335.3,16367,16211,156,0.9623095429
02208,2,むつ市,58493,61066,-2573,-4.2134739462,864.16,67.7,24475,24775,-300,-1.2108980827
02209,2,つがる市,33316,37243,-3927,-10.5442633515,253.55,131.4,10984,11473,-489,-4.2621807722
02210,2,平川市,32106,33764,-1658,-4.9105556214,346.01,92.8,10129,10063,66,0.6558680314
02301,3,平内町,11142,12361,-1219,-9.8616616779,217.09,51.3,3971,4198,-227,-5.4073368271
02303,3,今別町,2756,3217,-461,-14.330121231,125.27,22,1277,1379,-102,-7.3966642495
02304,3,蓬田村,2896,3271,-375,-11.4643839804,80.84,35.8,959,1070,-111,-10.3738317757
02307,3,外ヶ浜町,6198,7089,-891,-12.5687685146,230.29,26.9,2577,2789,-212,-7.6012907852
02321,3,鰺ヶ沢町,10126,11449,-1323,-11.5555943751,343.08,29.5,3851,4095,-244,-5.9584859585
02323,3,深浦町,8429,9691,-1262,-13.02239191,488.89,17.2,3304,3532,-228,-6.4552661382
02343,3,西目屋村,1415,1594,-179,-11.2296110414,246.02,5.8,488,570,-82,-14.3859649123
02361,3,藤崎町,15179,16021,-842,-5.2556020223,37.29,407.1,4942,4912,30,0.6107491857
02362,3,大鰐町,9676,10978,-1302,-11.860083804,163.43,59.2,3421,3648,-227,-6.2225877193
02367,3,田舎館村,7783,8153,-370,-4.538206795,22.35,348.2,2382,2406,-24,-0.9975062344
02381,3,板柳町,13935,15227,-1292,-8.4849280883,41.88,332.7,4680,4770,-90,-1.8867924528
02384,3,鶴田町,13392,14270,-878,-6.1527680448,46.43,288.4,4384,4402,-18,-0.4089050432
02387,3,中泊町,11187,12743,-1556,-12.2106254414,216.32,51.7,4118,4370,-252,-5.766590389
02401,3,野辺地町,13524,14314,-790,-5.519072237,81.68,165.6,5565,5766,-201,-3.4859521332
02402,3,七戸町,15709,16759,-1050,-6.2652902918,337.23,46.6,5572,5713,-141,-2.4680553124
02405,3,六戸町,10423,10241,182,1.7771701982,83.89,124.2,3570,3307,263,7.952827336
02406,3,横浜町,4535,4881,-346,-7.0887113296,126.38,35.9,1785,1884,-99,-5.2547770701
02408,3,東北町,17955,19106,-1151,-6.0242855647,326.5,55,5974,6007,-33,-0.5493590811
02411,3,六ヶ所村,10536,11095,-559,-5.038305543,252.68,41.7,4683,4751,-68,-1.4312776258
02412,3,おいらせ町,24222,24211,11,0.0454338937,71.96,336.6,8658,8330,328,3.93757503
02423,3,大間町,5227,6340,-1113,-17.5552050473,52.1,100.3,2152,2636,-484,-18.3611532625
02424,3,東通村,6607,7252,-645,-8.8940981798,295.27,22.4,2578,2710,-132,-4.8708487085
02425,3,風間浦村,1976,2463,-487,-19.772634998,69.55,28.4,823,1096,-273,-24.9087591241
02426,3,佐井村,2148,2422,-274,-11.3129644922,135.04,15.9,906,988,-82,-8.2995951417
02441,3,三戸町,10135,11299,-1164,-10.3017966192,151.79,66.8,3756,3961,-205,-5.1754607422
02442,3,五戸町,17433,18712,-1279,-6.8351859769,177.67,98.1,6123,6177,-54,-0.8742107819
02443,3,田子町,5554,6175,-621,-10.0566801619,241.98,23,2006,2097,-91,-4.3395326657
02445,3,南部町,18312,19853,-1541,-7.7620510754,153.12,119.6,6419,6621,-202,-3.0508986558
02446,3,階上町,14025,14699,-674,-4.5853459419,94.01,149.2,5699,5707,-8,-0.1401787279
02450,3,新郷村,2509,2851,-342,-11.9957909505,150.77,16.6,831,874,-43,-4.9199084668
03201,2,盛岡市,297631,298348,-717,-0.2403233807,886.47,335.7,129718,125096,4622,3.6947624225
03202,2,宮古市,56676,59430,-2754,-4.6340232206,1259.15,45,23387,22509,878,3.9006619574
03203,2,大船渡市,38058,40737,-2679,-6.5763310995,322.5,118,14807,14819,-12,-0.080977124
03205,2,花巻市,97702,101438,-3736,-3.6830379148,908.39,107.6,33799,33774,25,0.0740214366
03206,2,北上市,93511,93138,373,0.4004810067,437.55,213.7,35861,34068,1793,5.263003405
03207,2,久慈市,35642,36872,-1230,-3.3358646127,623.5,57.2,14256,14012,244,1.7413645447
03208,2,遠野市,28062,29331,-1269,-4.3264805155,825.97,34,9973,9888,85,0.8596278317
03209,2,一関市,121583,127642,-6059,-4.7468701525,1256.42,96.8,43046,42633,413,0.968733141
03210,2,陸前高田市,19758,23300,-3542,-15.2017167382,231.94,85.2,7487,7785,-298,-3.8278741169
03211,2,釜石市,36802,39574,-2772,-7.0045989791,440.34,83.6,16860,16094,766,4.7595377159
03213,2,二戸市,27611,29702,-2091,-7.039929971,420.42,65.7,10670,10847,-177,-1.631787591
03214,2,八幡平市,26355,28680,-2325,-8.1066945607,862.3,30.6,9429,9664,-235,-2.431705298
03215,2,奥州市,119422,124746,-5324,-4.2678723165,993.3,120.2,41726,41388,338,0.8166618343
03216,2,滝沢市,55463,53857,1606,2.9819707745,182.46,304,20787,19400,1387,7.1494845361
03301,3,雫石町,16981,18033,-1052,-5.8337492375,608.82,27.9,5508,5543,-35,-0.6314270251
03302,3,葛巻町,6344,7304,-960,-13.143483023,434.96,14.6,2460,2664,-204,-7.6576576577
03303,3,岩手町,13692,14984,-1292,-8.6225306994,360.46,38,4927,5039,-112,-2.2226632268
03321,3,紫波町,32614,33288,-674,-2.024753665,238.98,136.5,10808,10513,295,2.8060496528
03322,3,矢巾町,27678,27205,473,1.7386509833,67.32,411.1,9902,8856,1046,11.8112014453
03366,3,西和賀町,5880,6602,-722,-10.9360799758,590.74,10,2146,2272,-126,-5.5457746479
03381,3,金ケ崎町,15895,16325,-430,-2.6339969372,179.76,88.4,5556,5409,147,2.7176927343
03402,3,平泉町,7868,8345,-477,-5.7159976034,63.39,124.1,2478,2454,24,0.97799511
03441,3,住田町,5720,6190,-470,-7.5928917609,334.84,17.1,2117,2083,34,1.6322611618
03461,3,大槌町,11759,15276,-3517,-23.0230426813,200.42,58.7,4927,5689,-762,-13.3942696432
03482,3,山田町,15826,18617,-2791,-14.9916742762,262.81,60.2,6218,6605,-387,-5.8591975776
03483,3,岩泉町,9841,10804,-963,-8.9133654202,992.36,9.9,4174,4357,-183,-4.2001377094
03484,3,田野畑村,3466,3843,-377,-9.8100442363,156.19,22.2,1292,1309,-17,-1.2987012987
03485,3,普代村,2795,3088,-293,-9.4883419689,69.66,40.1,1103,1042,61,5.8541266795
03501,3,軽米町,9333,10209,-876,-8.5806641199,245.82,38,3318,3343,-25,-0.7478312893
03503,3,野田村,4149,4632,-483,-10.4274611399,80.8,51.3,1516,1578,-62,-3.9290240811
03506,3,九戸村,5865,6507,-642,-9.8662978331,134.02,43.8,1990,2034,-44,-2.1632251721
03507,3,洋野町,16693,17913,-1220,-6.8106961425,302.92,55.1,5959,6120,-161,-2.6307189542
03524,3,一戸町,12919,14187,-1268,-8.9377599211,300.03,43.1,4844,5047,-203,-4.0221914008
04100,1,仙台市,1082159,1045986,36173,3.4582680839,786.3,1376.3,498953,465260,33693,7.241757297
04101,0,仙台市 青葉区,310183,291436,18747,6.4326301486,302.24,1026.3,158562,144125,14437,10.0169991327
04102,0,仙台市 宮城野区,194825,190473,4352,2.284838271,58.19,3348.1,90166,85925,4241,4.9356997381
04103,0,仙台市 若林区,133498,132306,1192,0.9009417562,50.86,2624.8,61963,58914,3049,5.1753403266
04104,0,仙台市 太白区,226855,220588,6267,2.8410430304,228.39,993.3,98456,91526,6930,7.5716189935
04105,0,仙台市 泉区,216798,211183,5615,2.65883144,146.61,1478.7,89806,84770,5036,5.9407809367
04202,2,石巻市,147214,160826,-13612,-8.4638056036,554.58,265.5,56819,57871,-1052,-1.8178362219
04203,2,塩竈市,54187,56490,-2303,-4.0768277571,17.37,3119.6,20519,20396,123,0.6030594234
04205,2,気仙沼市,64988,73489,-8501,-11.5677176176,332.44,195.5,24152,25457,-1305,-5.1262913933
04206,2,白石市,35272,37422,-2150,-5.7452835231,286.48,123.1,12585,12532,53,0.4229173316
04207,2,名取市,76668,73134,3534,4.8322257773,98.17,781,27529,25124,2405,9.5725202993
04208,2,角田市,30180,31336,-1156,-3.6890477406,147.53,204.6,10398,10082,316,3.1342987502
04209,2,多賀城市,62096,63060,-964,-1.5287028227,19.69,3153.7,24097,24079,18,0.074753935
04211,2,岩沼市,44678,44187,491,1.1111865481,60.45,739.1,16631,15519,1112,7.1654101424
04212,2,登米市,81959,83969,-2010,-2.3937405471,536.12,152.9,26196,25002,1194,4.7756179506
04213,2,栗原市,69906,74932,-5026,-6.7074147227,804.97,86.8,23133,23407,-274,-1.1705899944
04214,2,東松島市,39503,42903,-3400,-7.9248537398,101.36,389.7,13868,14013,-145,-1.0347534432
04215,2,大崎市,133391,135147,-1756,-1.2993259192,796.76,167.4,48307,46146,2161,4.6829627703
04301,3,蔵王町,12316,12882,-566,-4.393727682,152.83,80.6,3923,3890,33,0.8483290488
04302,3,七ヶ宿町,1461,1694,-233,-13.7544273908,263.09,5.6,567,622,-55,-8.8424437299
04321,3,大河原町,23798,23530,268,1.1389715257,24.99,952.3,9099,8641,458,5.3003124638
04322,3,村田町,11501,11995,-494,-4.1183826594,78.38,146.7,3764,3630,134,3.6914600551
04323,3,柴田町,39525,39341,184,0.4677054472,54.03,731.5,15121,14490,631,4.3547273982
04324,3,川崎町,9167,9978,-811,-8.1278813389,270.77,33.9,2880,2887,-7,-0.2424662279
04341,3,丸森町,13972,15501,-1529,-9.8638797497,273.3,51.1,4547,4649,-102,-2.1940202194
04361,3,亘理町,33589,34845,-1256,-3.6045343665,73.6,456.4,11334,10903,431,3.9530404476
04362,3,山元町,12315,16704,-4389,-26.2751436782,64.58,190.7,4429,5235,-806,-15.3963705826
04401,3,松島町,14421,15085,-664,-4.4017235665,53.56,269.2,5112,5137,-25,-0.4866653689
04404,3,七ヶ浜町,18652,20416,-1764,-8.6402821317,13.19,1414.1,6167,6415,-248,-3.865939205
04406,3,利府町,35835,33994,1841,5.4156615873,44.89,798.3,12191,10818,1373,12.6918099464
04421,3,大和町,28244,24894,3350,13.4570579256,225.49,125.3,10177,8056,2121,26.3282025819
04422,3,大郷町,8370,8927,-557,-6.2394981517,82.01,102.1,2421,2423,-2,-0.0825423029
04423,3,富谷町,51591,47042,4549,9.6700820543,49.18,1049,17494,15399,2095,13.6047795311
04424,3,大衡村,5703,5334,369,6.9178852643,60.32,94.5,1755,1490,265,17.7852348993
04444,3,色麻町,7238,7431,-193,-2.5972278294,109.28,66.2,1974,1923,51,2.6521060842
04445,3,加美町,23743,25527,-1784,-6.988678654,460.67,51.5,7564,7597,-33,-0.4343819929
04501,3,涌谷町,16701,17494,-793,-4.5329827369,82.16,203.3,5476,5496,-20,-0.3639010189
04505,3,美里町,24852,25190,-338,-1.3418023025,74.95,331.6,8343,8010,333,4.1573033708
04581,3,女川町,6334,10051,-3717,-36.9813948861,65.35,96.9,3154,3968,-814,-20.5141129032
04606,3,南三陸町,12370,17429,-5059,-29.026335418,163.4,75.7,4041,5295,-1254,-23.6827195467
05201,2,秋田市,315814,323600,-7786,-2.4060568603,906.09,348.5,135318,131318,4000,3.0460409083
05202,2,能代市,54730,59084,-4354,-7.3691693183,426.95,128.2,22371,22806,-435,-1.9073927914
05203,2,横手市,92197,98367,-6170,-6.2724287617,692.8,133.1,31463,31807,-344,-1.0815229352
05204,2,大館市,74175,78946,-4771,-6.0433714184,913.22,81.2,28242,28565,-323,-1.1307544197
05206,2,男鹿市,28375,32294,-3919,-12.1353811854,241.09,117.7,11147,11625,-478,-4.111827957
05207,2,湯沢市,46613,50849,-4236,-8.3305473067,790.91,58.9,16384,16855,-471,-2.7944230199
05209,2,鹿角市,32038,34473,-2435,-7.0634989702,707.52,45.3,11508,11863,-355,-2.9924976819
05210,2,由利本荘市,79927,85229,-5302,-6.2208872567,1209.6,66.1,28349,28648,-299,-1.0437028763
05211,2,潟上市,33083,34442,-1359,-3.9457638929,97.73,338.5,12023,11936,87,0.7288873995
05212,2,大仙市,82783,88301,-5518,-6.2490798519,866.77,95.5,28198,28354,-156,-0.5501869225
05213,2,北秋田市,33224,36387,-3163,-8.6926649628,1152.76,28.8,12222,12837,-615,-4.7908389811
05214,2,にかほ市,25324,27544,-2220,-8.0598315423,241.13,105,8804,9203,-399,-4.3355427578
05215,2,仙北市,27523,29568,-2045,-6.9162608225,1093.56,25.2,9594,9859,-265,-2.6878993813
05303,3,小坂町,5339,6054,-715,-11.8103733069,201.7,26.5,2168,2390,-222,-9.2887029289
05327,3,上小阿仁村,2381,2727,-346,-12.6879354602,256.72,9.3,918,1008,-90,-8.9285714286
05346,3,藤里町,3359,3848,-489,-12.7079002079,282.13,11.9,1215,1322,-107,-8.0937972769
05348,3,三種町,17078,18876,-1798,-9.5253231617,247.98,68.9,6010,6294,-284,-4.5122338735
05349,3,八峰町,7309,8220,-911,-11.0827250608,234.14,31.2,2706,2870,-164,-5.7142857143
05361,3,五城目町,9463,10516,-1053,-10.0133130468,214.92,44,3573,3733,-160,-4.2860969729
05363,3,八郎潟町,6080,6623,-543,-8.1987014948,17,357.6,2220,2303,-83,-3.6039947894
05366,3,井川町,4986,5493,-507,-9.2299290005,47.95,104,1563,1604,-41,-2.5561097257
05368,3,大潟村,3110,3218,-108,-3.3561218148,170.11,18.3,796,804,-8,-0.9950248756
05434,3,美郷町,20279,21674,-1395,-6.4362831042,168.34,120.5,6152,6291,-139,-2.209505643
05463,3,羽後町,15319,16792,-1473,-8.772034302,230.78,66.4,4807,4966,-159,-3.2017720499
05464,3,東成瀬村,2610,2872,-262,-9.1225626741,203.69,12.8,809,875,-66,-7.5428571429
06201,2,山形市,253832,254244,-412,-0.1620490552,381.3,665.7,100303,96560,3743,3.8763463132
06202,2,米沢市,85953,89401,-3448,-3.8567801255,548.51,156.7,32997,33013,-16,-0.0484657559
06203,2,鶴岡市,129652,136623,-6971,-5.1023619742,1311.53,98.9,45339,45514,-175,-0.3844970778
06204,2,酒田市,106244,111151,-4907,-4.4147151173,602.97,176.2,39320,38955,365,0.936978565
06205,2,新庄市,36894,38850,-1956,-5.0347490347,222.85,165.6,12961,12980,-19,-0.1463790447
06206,2,寒河江市,41256,42373,-1117,-2.6361126189,139.03,296.7,13086,12717,369,2.9016277424
06207,2,上山市,31569,33836,-2267,-6.6999645348,240.93,131,10694,10751,-57,-0.5301832388
06208,2,村山市,24684,26811,-2127,-7.9333109545,196.98,125.3,7713,7865,-152,-1.9326128417
06209,2,長井市,27757,29473,-1716,-5.8222780172,214.67,129.3,9109,9269,-160,-1.7261840544
06210,2,天童市,62194,62214,-20,-0.0321471052,113.01,550.3,21428,20404,1024,5.0186237993
06211,2,東根市,47768,46414,1354,2.9172232516,206.94,230.8,15473,14388,1085,7.5410063942
06212,2,尾花沢市,16953,18955,-2002,-10.5618570298,372.53,45.5,5109,5332,-223,-4.1822955739
06213,2,南陽市,32285,33658,-1373,-4.0792679304,160.52,201.1,10705,10567,138,1.3059524936
06301,3,山辺町,14369,15139,-770,-5.0862012022,61.45,233.8,4440,4419,21,0.4752206382
06302,3,中山町,11363,12015,-652,-5.4265501457,31.15,364.8,3427,3423,4,0.1168565586
06321,3,河北町,18952,19959,-1007,-5.0453429531,52.45,361.3,5865,5740,125,2.1777003484
06322,3,西川町,5636,6270,-634,-10.1116427432,393.19,14.3,1785,1853,-68,-3.6697247706
06323,3,朝日町,7119,7856,-737,-9.3813645621,196.81,36.2,2242,2311,-69,-2.9857204673
06324,3,大江町,8472,9227,-755,-8.1825078574,154.08,55,2632,2691,-59,-2.1924934968
06341,3,大石田町,7357,8160,-803,-9.8406862745,79.54,92.5,2143,2227,-84,-3.7718904356
06361,3,金山町,5829,6365,-536,-8.4210526316,161.67,36.1,1643,1703,-60,-3.5231943629
06362,3,最上町,8902,9847,-945,-9.5968315223,330.37,26.9,2665,2764,-99,-3.5817655572
06363,3,舟形町,5631,6164,-533,-8.6469824789,119.04,47.3,1621,1652,-31,-1.8765133172
06364,3,真室川町,8137,9165,-1028,-11.2165848336,374.22,21.7,2478,2631,-153,-5.8152793615
06365,3,大蔵村,3412,3762,-350,-9.3035619351,211.63,16.1,1016,1045,-29,-2.7751196172
06366,3,鮭川村,4317,4862,-545,-11.2093788564,122.14,35.3,1224,1300,-76,-5.8461538462
06367,3,戸沢村,4773,5304,-531,-10.0113122172,261.31,18.3,1390,1451,-61,-4.2039972433
06381,3,高畠町,23882,25025,-1143,-4.5674325674,180.26,132.5,7218,7241,-23,-0.3176356857
06382,3,川西町,15751,17313,-1562,-9.0221221048,166.6,94.5,4553,4710,-157,-3.3333333333
06401,3,小国町,7868,8862,-994,-11.2164296998,737.56,10.7,2845,3036,-191,-6.2911725955
06402,3,白鷹町,14175,15314,-1139,-7.4376387619,157.71,89.9,4405,4465,-60,-1.3437849944
06403,3,飯豊町,7304,7943,-639,-8.0448193378,329.41,22.2,2198,2235,-37,-1.6554809843
06426,3,三川町,7728,7731,-3,-0.0388048118,33.22,232.6,2223,2140,83,3.8785046729
06428,3,庄内町,21666,23158,-1492,-6.4426979877,249.17,87,6637,6648,-11,-0.1654632972
06461,3,遊佐町,14207,15480,-1273,-8.2235142119,208.39,68.2,4509,4608,-99,-2.1484375
07201,2,福島市,294247,292590,1657,0.5663214737,767.72,383.3,122269,113074,9195,8.131842864
07202,2,会津若松市,124062,126220,-2158,-1.7097131992,382.97,323.9,49431,47891,1540,3.2156355056
07203,2,郡山市,335444,338712,-3268,-0.9648314793,757.2,443,138310,131740,6570,4.9870957947
07204,2,いわき市,350237,342249,7988,2.3339732183,1232.02,284.3,141069,128722,12347,9.5919889374
07205,2,白河市,61913,64704,-2791,-4.3134891197,305.32,202.8,23004,22726,278,1.223268503
07207,2,須賀川市,77441,79267,-1826,-2.3036067973,279.43,277.1,26345,25792,553,2.1440756824
07208,2,喜多方市,49377,52356,-2979,-5.689892276,554.63,89,16752,16983,-231,-1.3601837131
07209,2,相馬市,38556,37817,739,1.9541476056,197.79,194.9,15209,13227,1982,14.9845013987
07210,2,二本松市,58162,59871,-1709,-2.8544704448,344.42,168.9,19810,18364,1446,7.8741015029
07211,2,田村市,38503,40422,-1919,-4.7474147741,458.33,84,12734,11933,801,6.7124780022
07212,2,南相馬市,57797,70878,-13081,-18.455656198,398.58,145,25944,23640,2304,9.7461928934
07213,2,伊達市,62400,66027,-3627,-5.4932073243,265.12,235.4,21624,20870,754,3.6128413991
07214,2,本宮市,30924,31489,-565,-1.7942773667,88.02,351.3,10049,9538,511,5.3575172992
07301,3,桑折町,12271,12853,-582,-4.5281257294,42.97,285.6,4276,4055,221,5.4500616523
07303,3,国見町,9512,10086,-574,-5.6910569106,37.95,250.6,3291,3204,87,2.7153558052
07308,3,川俣町,14452,15569,-1117,-7.1745134562,127.7,113.2,5515,5179,336,6.4877389457
07322,3,大玉村,8679,8574,105,1.2246326102,79.44,109.3,2619,2253,366,16.2450066578
07342,3,鏡石町,12486,12815,-329,-2.5673039407,31.3,398.9,4205,4076,129,3.1648675172
07344,3,天栄村,5611,6291,-680,-10.8090923542,225.52,24.9,1638,1669,-31,-1.8573996405
07362,3,下郷町,5800,6461,-661,-10.230614456,317.04,18.3,2002,2103,-101,-4.8026628626
07364,3,檜枝岐村,615,636,-21,-3.3018867925,390.46,1.6,257,221,36,16.2895927602
07367,3,只見町,4470,4932,-462,-9.3673965937,747.56,6,1762,1851,-89,-4.8082117774
07368,3,南会津町,16264,17864,-1600,-8.9565606807,886.47,18.3,6246,6507,-261,-4.0110650069
07402,3,北塩原村,2831,3185,-354,-11.114599686,234.08,12.1,1008,1052,-44,-4.1825095057
07405,3,西会津町,6582,7366,-784,-10.6434971491,298.18,22.1,2531,2653,-122,-4.5985676593
07407,3,磐梯町,3579,3761,-182,-4.839138527,59.77,59.9,1117,1131,-14,-1.2378426172
07408,3,猪苗代町,15037,15805,-768,-4.8592217653,394.85,38.1,4939,4954,-15,-0.3027856278
07421,3,会津坂下町,16303,17360,-1057,-6.0887096774,91.59,178,5391,5371,20,0.3723701359
07422,3,湯川村,3206,3364,-158,-4.6967895363,16.37,195.8,906,915,-9,-0.9836065574
07423,3,柳津町,3536,4009,-473,-11.7984534797,175.82,20.1,1207,1259,-52,-4.1302621128
07444,3,三島町,1668,1926,-258,-13.3956386293,90.81,18.4,674,747,-73,-9.7724230254
07445,3,金山町,2189,2462,-273,-11.0885458976,293.92,7.4,956,1042,-86,-8.2533589251
07446,3,昭和村,1322,1500,-178,-11.8666666667,209.46,6.3,616,646,-30,-4.6439628483
07447,3,会津美里町,20913,22737,-1824,-8.0221665127,276.33,75.7,6710,6806,-96,-1.4105201293
07461,3,西郷村,20322,19767,555,2.8077098194,192.06,105.8,7458,6711,747,11.1309789897
07464,3,泉崎村,6495,6802,-307,-4.5133784181,35.43,183.3,2059,2006,53,2.6420737787
07465,3,中島村,5001,5154,-153,-2.9685681024,18.92,264.3,1395,1387,8,0.5767844268
07466,3,矢吹町,17370,18407,-1037,-5.6337262998,60.4,287.6,5846,5943,-97,-1.6321723036
07481,3,棚倉町,14295,15062,-767,-5.0922852211,159.93,89.4,4753,4708,45,0.9558198811
07482,3,矢祭町,5950,6348,-398,-6.2696912413,118.27,50.3,1921,1932,-11,-0.5693581781
07483,3,塙町,9157,9884,-727,-7.3553217321,211.41,43.3,3043,3086,-43,-1.393389501
07484,3,鮫川村,3577,3989,-412,-10.3284031085,131.34,27.2,1064,1106,-42,-3.7974683544
07501,3,石川町,15880,17775,-1895,-10.6610407876,115.71,137.2,5244,5370,-126,-2.3463687151
07502,3,玉川村,6777,7231,-454,-6.2785230259,46.67,145.2,1974,1923,51,2.6521060842
07503,3,平田村,6505,6921,-416,-6.0106920965,93.42,69.6,1989,2008,-19,-0.9462151394
07504,3,浅川町,6577,6888,-311,-4.5150987224,37.43,175.7,2055,2029,26,1.2814194184
07505,3,古殿町,5373,6030,-657,-10.8955223881,163.29,32.9,1661,1728,-67,-3.8773148148
07521,3,三春町,18304,18191,113,0.6211863009,72.76,251.6,6230,5502,728,13.2315521628
07522,3,小野町,10475,11202,-727,-6.4899125156,125.18,83.7,3425,3495,-70,-2.0028612303
07541,3,広野町,4319,5418,-1099,-20.2842377261,58.69,73.6,2435,1810,625,34.5303867403
07542,3,楢葉町,975,7700,-6725,-87.3376623377,103.64,9.4,839,2576,-1737,-67.4301242236
07543,3,富岡町,0,16001,-16001,-100,68.39,0,0,6141,-6141,-100
07544,3,川内村,2021,2820,-799,-28.3333333333,197.35,10.2,1082,950,132,13.8947368421
07545,3,大熊町,0,11515,-11515,-100,78.71,0,0,3955,-3955,-100
07546,3,双葉町,0,6932,-6932,-100,51.42,0,0,2393,-2393,-100
07547,3,浪江町,0,20905,-20905,-100,223.14,0,0,7176,-7176,-100
07548,3,葛尾村,18,1531,-1513,-98.8242978445,84.37,0.2,9,470,-461,-98.085106383
07561,3,新地町,8218,8224,-6,-0.0729571984,46.53,176.6,2699,2461,238,9.6708655018
07564,3,飯舘村,41,6209,-6168,-99.3396682235,230.13,0.2,1,1734,-1733,-99.9423298731
08201,2,水戸市,270783,268750,2033,0.7564651163,217.32,1246,117590,112099,5491,4.898348781
08202,2,日立市,185054,193129,-8075,-4.1811431737,225.74,819.8,78625,77965,660,0.846533701
08203,2,土浦市,140804,143839,-3035,-2.1099979839,122.89,1145.8,57257,56663,594,1.0483031255
08204,2,古河市,140946,142995,-2049,-1.4329172349,123.58,1140.5,52571,50465,2106,4.1731893391
08205,2,石岡市,76020,79687,-3667,-4.6017543639,215.53,352.7,27288,27094,194,0.7160256883
08207,2,結城市,51594,52494,-900,-1.714481655,65.76,784.6,18267,17466,801,4.5860529028
08208,2,龍ケ崎市,78342,80334,-1992,-2.4796474718,78.55,997.4,30472,30092,380,1.2627940981
08210,2,下妻市,43293,44987,-1694,-3.7655322649,80.88,535.3,15036,14890,146,0.9805238415
08211,2,常総市,61483,65320,-3837,-5.8741579914,123.64,497.3,20600,20685,-85,-0.4109257916
08212,2,常陸太田市,52294,56250,-3956,-7.0328888889,371.99,140.6,19436,19801,-365,-1.8433412454
08214,2,高萩市,29638,31017,-1379,-4.4459489957,193.58,153.1,11751,11661,90,0.7718034474
08215,2,北茨城市,44412,47026,-2614,-5.5586271424,186.8,237.8,16871,16966,-95,-0.5599434162
08216,2,笠間市,76739,79409,-2670,-3.3623392814,240.4,319.2,28202,27946,256,0.9160523867
08217,2,取手市,106570,109651,-3081,-2.8098238958,69.94,1523.7,43477,42614,863,2.025156052
08219,2,牛久市,84317,81684,2633,3.223397483,58.92,1431,33223,31569,1654,5.2393170515
08220,2,つくば市,226963,214590,12373,5.7658791183,283.72,800,98190,87477,10713,12.2466476903
08221,2,ひたちなか市,155689,157060,-1371,-0.8729148096,99.93,1558,61104,60268,836,1.3871374527
08222,2,鹿嶋市,67879,66093,1786,2.7022528861,106.02,640.2,27450,25199,2251,8.9328941625
08223,2,潮来市,29111,30534,-1423,-4.6603785944,71.4,407.7,10547,10384,163,1.5697226502
08224,2,守谷市,64753,62482,2271,3.6346467783,35.71,1813.3,24867,22854,2013,8.8080861118
08225,2,常陸大宮市,42587,45178,-2591,-5.7350923016,348.45,122.2,16005,16087,-82,-0.5097283521
08226,2,那珂市,54276,54240,36,0.0663716814,97.82,554.9,20025,18889,1136,6.0140822701
08227,2,筑西市,104573,108527,-3954,-3.6433329955,205.3,509.4,35683,35188,495,1.4067295669
08228,2,坂東市,54087,56114,-2027,-3.6122892683,123.03,439.6,17327,16763,564,3.3645528843
08229,2,稲敷市,42810,46895,-4085,-8.7109499947,205.81,208,14453,14809,-356,-2.4039435478
08230,2,かすみがうら市,42147,43553,-1406,-3.2282506372,156.6,269.1,15142,14730,412,2.7970128988
08231,2,桜川市,42632,45673,-3041,-6.6582006875,180.06,236.8,13585,13632,-47,-0.3447769953
08232,2,神栖市,94522,94795,-273,-0.2879898729,146.94,643.3,37221,35901,1320,3.6767778056
08233,2,行方市,34909,37611,-2702,-7.1840684906,222.48,156.9,11115,11346,-231,-2.0359598096
08234,2,鉾田市,48147,50156,-2009,-4.0055028312,207.61,231.9,17430,16810,620,3.6882807852
08235,2,つくばみらい市,49136,44461,4675,10.5148332246,79.16,620.7,18137,15273,2864,18.7520460944
08236,2,小美玉市,50911,52279,-1368,-2.6167294707,144.74,351.7,17491,17207,284,1.6504910792
08302,3,茨城町,32921,34513,-1592,-4.6127546142,121.58,270.8,11356,11187,169,1.5106820417
08309,3,大洗町,16886,18328,-1442,-7.8677433435,23.74,711.3,6661,7021,-360,-5.1274747187
08310,3,城里町,19800,21491,-1691,-7.8684100321,161.8,122.4,7066,7142,-76,-1.0641276953
08341,3,東海村,37713,37438,275,0.7345477857,37.98,993,14494,14113,381,2.699638631
08364,3,大子町,18053,20073,-2020,-10.0632690679,325.76,55.4,6733,7140,-407,-5.700280112
08442,3,美浦村,15842,17299,-1457,-8.4224521649,66.61,237.8,5958,6305,-347,-5.5035685964
08443,3,阿見町,47535,47940,-405,-0.8448060075,71.4,665.8,18801,17969,832,4.6301964494
08447,3,河内町,9168,10172,-1004,-9.8702320094,44.3,207,2950,3004,-54,-1.7976031957
08521,3,八千代町,22021,23106,-1085,-4.6957500216,58.99,373.3,6799,6756,43,0.6364712848
08542,3,五霞町,8786,9410,-624,-6.6312433581,23.11,380.2,2894,2927,-33,-1.127434233
08546,3,境町,24517,25714,-1197,-4.6550517228,46.59,526.2,8061,7923,138,1.7417644832
08564,3,利根町,16313,17473,-1160,-6.6388141704,24.9,655.1,6138,6131,7,0.1141738705
09201,2,宇都宮市,518594,511739,6855,1.3395500441,416.85,1244.1,217419,210482,6937,3.2957687593
09202,2,足利市,149452,154530,-5078,-3.2860933152,177.76,840.8,60186,59134,1052,1.7790103832
09203,2,栃木市,159211,164024,-4813,-2.9343266839,331.5,480.3,57838,56489,1349,2.3880755545
09204,2,佐野市,118919,121249,-2330,-1.9216653333,356.04,334,46390,45178,1212,2.6827216787
09205,2,鹿沼市,98374,102348,-3974,-3.8828311252,490.64,200.5,35079,34999,80,0.2285779594
09206,2,日光市,83386,90066,-6680,-7.4167832478,1449.83,57.5,32658,33926,-1268,-3.7375464246
09208,2,小山市,166760,164454,2306,1.4022158172,171.76,970.9,65792,62844,2948,4.6909808414
09209,2,真岡市,79539,82289,-2750,-3.3418804457,167.34,475.3,27949,27577,372,1.3489502121
09210,2,大田原市,75457,77729,-2272,-2.9229759807,354.36,212.9,28753,28075,678,2.4149599288
09211,2,矢板市,33354,35343,-1989,-5.6277056277,170.46,195.7,12342,12438,-96,-0.7718282682
09213,2,那須塩原市,117146,117812,-666,-0.565307439,592.74,197.6,45608,44602,1006,2.2555042375
09214,2,さくら市,44901,44768,133,0.2970872051,125.63,357.4,15648,14917,731,4.900449152
09215,2,那須烏山市,27047,29206,-2159,-7.3923166473,174.35,155.1,9439,9586,-147,-1.5334863342
09216,2,下野市,59431,59483,-52,-0.0874199351,74.59,796.8,21394,20501,893,4.3558850788
09301,3,上三川町,31046,31621,-575,-1.8184118149,54.39,570.8,10777,10390,387,3.7247353224
09342,3,益子町,23281,24348,-1067,-4.3822901265,89.4,260.4,7787,7801,-14,-0.1794641713
09343,3,茂木町,13188,15018,-1830,-12.1853775469,172.69,76.4,4572,4799,-227,-4.730152115
09344,3,市貝町,11720,12094,-374,-3.0924425335,64.25,182.4,4109,4018,91,2.2648083624
09345,3,芳賀町,15189,16030,-841,-5.2464129757,70.16,216.5,4957,4907,50,1.0189525168
09361,3,壬生町,39951,39605,346,0.8736270673,61.06,654.3,15258,14214,1044,7.3448712537
09364,3,野木町,25292,25720,-428,-1.6640746501,30.26,835.8,9530,9122,408,4.4727033545
09384,3,塩谷町,11495,12560,-1065,-8.4792993631,176.06,65.3,3696,3828,-132,-3.4482758621
09386,3,高根沢町,29639,30436,-797,-2.6186095413,70.87,418.2,11521,11201,320,2.8568877779
09407,3,那須町,24919,26765,-1846,-6.8970670652,372.34,66.9,8564,8699,-135,-1.5519025175
09411,3,那珂川町,16964,18446,-1482,-8.0342621707,192.78,88,5831,5877,-46,-0.7827122682
10201,2,前橋市,336154,340291,-4137,-1.215724189,311.59,1078.8,136900,133322,3578,2.6837281169
10202,2,高崎市,370884,371302,-418,-0.1125768243,459.16,807.7,150180,147116,3064,2.0827102423
10203,2,桐生市,114714,121704,-6990,-5.7434431079,274.45,418,46034,46688,-654,-1.4007882111
10204,2,伊勢崎市,208814,207221,1593,0.7687444805,139.44,1497.5,80110,76527,3583,4.6820076574
10205,2,太田市,219807,216465,3342,1.5438985517,175.54,1252.2,86267,81437,4830,5.9309650405
10206,2,沼田市,48676,51265,-2589,-5.0502292012,443.46,109.8,19178,19148,30,0.1566743263
10207,2,館林市,76667,78608,-1941,-2.4692143293,60.97,1257.5,30219,29581,638,2.1567898313
10208,2,渋川市,78391,83330,-4939,-5.9270370815,240.27,326.3,28812,29290,-478,-1.6319562991
10209,2,藤岡市,65708,67975,-2267,-3.3350496506,180.29,364.5,24569,24298,271,1.1153181332
10210,2,富岡市,49746,52070,-2324,-4.463222585,122.85,404.9,18255,18297,-42,-0.2295458272
10211,2,安中市,58531,61077,-2546,-4.1685086039,276.31,211.8,22381,22184,197,0.8880274071
10212,2,みどり市,50906,51899,-993,-1.9133316634,208.42,244.2,18867,18336,531,2.8959424084
10344,3,榛東村,14329,14370,-41,-0.2853166319,27.92,513.2,4887,4634,253,5.4596460941
10345,3,吉岡町,21080,19801,1279,6.4592697339,20.46,1030.3,7289,6530,759,11.6232771822
10366,3,上野村,1230,1306,-76,-5.819295559,181.85,6.8,578,612,-34,-5.5555555556
10367,3,神流町,1954,2352,-398,-16.9217687075,114.6,17.1,903,1038,-135,-13.0057803468
10382,3,下仁田町,7564,8911,-1347,-15.1161485804,188.38,40.2,3040,3316,-276,-8.3232810615
10383,3,南牧村,1979,2423,-444,-18.3243912505,118.83,16.7,953,1088,-135,-12.4080882353
10384,3,甘楽町,13200,13618,-418,-3.0694668821,58.61,225.2,4539,4447,92,2.068810434
10421,3,中之条町,16850,18216,-1366,-7.4989020641,439.28,38.4,6529,6608,-79,-1.1955205811
10424,3,長野原町,5536,6017,-481,-7.994016952,133.85,41.4,2322,2295,27,1.1764705882
10425,3,嬬恋村,9780,10183,-403,-3.9575763527,337.58,29,3664,3651,13,0.356066831
10426,3,草津町,6518,7160,-642,-8.9664804469,49.75,131,3275,3474,-199,-5.7282671272
10428,3,高山村,3674,3911,-237,-6.0598312452,64.18,57.2,1167,1179,-12,-1.0178117048
10429,3,東吾妻町,14033,15622,-1589,-10.1715529382,253.91,55.3,5235,5519,-284,-5.1458597572
10443,3,片品村,4390,4904,-514,-10.4812398042,391.76,11.2,1554,1677,-123,-7.3345259392
10444,3,川場村,3647,3898,-251,-6.4391995895,85.25,42.8,980,974,6,0.6160164271
10448,3,昭和村,7347,7620,-273,-3.5826771654,64.14,114.5,2476,2429,47,1.9349526554
10449,3,みなかみ町,19347,21345,-1998,-9.3605059733,781.08,24.8,7594,7864,-270,-3.4333672431
10464,3,玉村町,36654,37536,-882,-2.3497442455,25.78,1421.8,14337,13857,480,3.4639532366
10521,3,板倉町,15015,15706,-691,-4.3995925124,41.86,358.7,5365,5129,236,4.6012868005
10522,3,明和町,11044,11209,-165,-1.4720314033,19.64,562.3,3914,3696,218,5.8982683983
10523,3,千代田町,11318,11473,-155,-1.3509979953,21.73,520.8,3981,3719,262,7.0449045442
10524,3,大泉町,41202,40257,945,2.3474178404,18.03,2285.2,18070,16600,1470,8.8554216867
10525,3,邑楽町,26426,27023,-597,-2.2092291751,31.11,849.4,9528,9196,332,3.6102653328
11100,1,さいたま市,1263979,1222434,41545,3.398547488,217.43,5813.3,533209,503126,30083,5.9792179295
11101,0,さいたま市 西区,87146,84029,3117,3.7094336479,29.12,2992.7,33871,31406,2465,7.8488186971
11102,0,さいたま市 北区,143446,138630,4816,3.4739955277,16.86,8508.1,61756,58382,3374,5.7791785139
11103,0,さいたま市 大宮区,113864,108488,5376,4.9553867709,12.8,8895.6,53265,48475,4790,9.8813821558
11104,0,さいたま市 見沼区,161960,157143,4817,3.0653608497,30.69,5277.3,65666,61585,4081,6.6266136234
11105,0,さいたま市 中央区,98762,96055,2707,2.818177086,8.39,11771.4,42872,41153,1719,4.17709523
11106,0,さいたま市 桜区,97910,96911,999,1.030842732,18.64,5252.7,43331,42442,889,2.0946232506
11107,0,さいたま市 浦和区,154416,144786,9630,6.6511955576,11.51,13415.8,67136,61994,5142,8.2943510662
11108,0,さいたま市 南区,180152,174988,5164,2.9510595012,13.82,13035.6,77895,74885,3010,4.0194965614
11109,0,さいたま市 緑区,116522,110118,6404,5.8155796509,26.44,4407,44475,40862,3613,8.8419558514
11110,0,さいたま市 岩槻区,109801,111286,-1485,-1.3343996549,49.17,2233.1,42942,41942,1000,2.3842449096
11201,2,川越市,350745,342670,8075,2.3564945866,109.13,3214,145715,137121,8594,6.2674572093
11202,2,熊谷市,198742,203180,-4438,-2.1842701053,159.82,1243.5,77004,75413,1591,2.1097158315
11203,2,川口市,578112,561506,16606,2.957403839,61.95,9331.9,245830,234124,11706,4.9999145752
11206,2,行田市,82113,85786,-3673,-4.2815844077,67.49,1216.7,31015,30630,385,1.2569376428
11207,2,秩父市,63555,66955,-3400,-5.0780374879,577.83,110,24038,24146,-108,-0.4472790524
11208,2,所沢市,340386,341924,-1538,-0.4498075596,72.11,4720.4,145834,141225,4609,3.2635864755
11209,2,飯能市,80715,83549,-2834,-3.3920214485,193.05,418.1,31749,30905,844,2.7309496845
11210,2,加須市,112229,115002,-2773,-2.4112624128,133.3,841.9,41034,39460,1574,3.9888494678
11211,2,本庄市,77881,81889,-4008,-4.8944302654,89.69,868.3,31004,32217,-1213,-3.7650929633
11212,2,東松山市,91437,90099,1338,1.4850331302,65.35,1399.2,37224,34945,2279,6.5216769209
11214,2,春日部市,232709,237171,-4462,-1.8813429972,66,3525.9,94463,91531,2932,3.2032863183
11215,2,狭山市,152405,155727,-3322,-2.133220315,48.99,3110.9,62028,61039,989,1.6202755615
11216,2,羽生市,54874,56204,-1330,-2.3663796171,58.64,935.8,20366,19473,893,4.5858367997
11217,2,鴻巣市,118072,119639,-1567,-1.3097735688,67.44,1750.8,45043,43379,1664,3.835957491
11218,2,深谷市,143811,144618,-807,-0.558021823,138.37,1039.3,53384,50859,2525,4.964706345
11219,2,上尾市,225196,223926,1270,0.5671516483,45.51,4948.3,91399,87286,4113,4.7120958688
11221,2,草加市,247034,243855,3179,1.3036435587,27.46,8996.1,105827,102479,3348,3.2670108022
11222,2,越谷市,337498,326313,11185,3.4276905915,60.24,5602.6,136460,128342,8118,6.3252871235
11223,2,蕨市,72260,71502,758,1.0601102067,5.11,14140.9,34174,33112,1062,3.2072964484
11224,2,戸田市,136150,123079,13071,10.6200082874,18.19,7484.9,59432,54495,4937,9.0595467474
11225,2,入間市,148390,149872,-1482,-0.9888438134,44.69,3320.4,59004,56843,2161,3.8016994177
11227,2,朝霞市,136299,129691,6608,5.0951877925,18.34,7431.8,59515,56790,2725,4.7983799965
11228,2,志木市,72676,69611,3065,4.4030397495,9.05,8030.5,30607,28433,2174,7.6460450885
11229,2,和光市,80826,80745,81,0.100315809,11.04,7321.2,36898,37385,-487,-1.3026614953
11230,2,新座市,162122,158777,3345,2.1067283045,22.78,7116.9,67250,64436,2814,4.367123968
11231,2,桶川市,73936,74711,-775,-1.0373305136,25.35,2916.6,28685,28047,638,2.274753093
11232,2,久喜市,152311,154310,-1999,-1.2954442356,82.41,1848.2,59082,57238,1844,3.2216359761
11233,2,北本市,67409,68888,-1479,-2.1469631866,19.82,3401.1,26845,25856,989,3.8250309406
11234,2,八潮市,86717,82977,3740,4.5072730998,18.02,4812.3,35763,32467,3296,10.1518464903
11235,2,富士見市,108102,106736,1366,1.2797931345,19.77,5468,47169,44642,2527,5.6605886833
11237,2,三郷市,136521,131415,5106,3.8854012099,30.13,4531.1,55288,51132,4156,8.1279824767
11238,2,蓮田市,62380,63309,-929,-1.4674058981,27.28,2286.7,24543,23445,1098,4.6833013436
11239,2,坂戸市,101679,101700,-21,-0.0206489676,41.02,2478.8,42883,41508,1375,3.3126144358
11240,2,幸手市,52524,54012,-1488,-2.7549433459,33.93,1548,20568,19904,664,3.3360128617
11241,2,鶴ヶ島市,70255,69990,265,0.3786255179,17.65,3980.5,28658,27746,912,3.2869602826
11242,2,日高市,56520,57473,-953,-1.6581699233,47.48,1190.4,22145,21227,918,4.324680831
11243,2,吉川市,69738,65298,4440,6.7995956997,31.66,2202.7,25716,23248,2468,10.6159669649
11245,2,ふじみ野市,110970,105695,5275,4.9907753442,14.64,7579.9,45806,42763,3043,7.1159647359
11246,2,白岡市,51535,50272,1263,2.512332909,24.92,2068,19183,17869,1314,7.3535172645
11301,3,伊奈町,44442,42494,1948,4.5841765896,14.79,3004.9,16701,15504,1197,7.7205882353
11324,3,三芳町,38456,38706,-250,-0.6458946933,15.33,2508.5,14328,13940,388,2.7833572453
11326,3,毛呂山町,37275,39054,-1779,-4.5552312183,34.07,1094.1,15566,15644,-78,-0.49859371
11327,3,越生町,11716,12537,-821,-6.5486160964,40.39,290.1,4527,4566,-39,-0.8541392904
11341,3,滑川町,18212,17323,889,5.1319055591,29.68,613.6,6785,6186,599,9.6831555124
11342,3,嵐山町,18341,18887,-546,-2.890877323,29.92,613,6968,6708,260,3.8759689922
11343,3,小川町,31178,32913,-1735,-5.271473278,60.36,516.5,12007,11645,362,3.1086303134
11346,3,川島町,20788,22147,-1359,-6.1362712783,41.63,499.4,7238,7112,126,1.7716535433
11347,3,吉見町,19631,21079,-1448,-6.8693960814,38.64,508,6834,6804,30,0.4409171076
11348,3,鳩山町,14338,15305,-967,-6.3181966678,25.73,557.2,5309,5335,-26,-0.4873477038
11349,3,ときがわ町,11492,12418,-926,-7.456917378,55.9,205.6,4199,4281,-82,-1.9154403177
11361,3,横瀬町,8519,9039,-520,-5.7528487665,49.36,172.6,3074,3078,-4,-0.1299545159
11362,3,皆野町,10133,10888,-755,-6.9342395298,63.74,159,3662,3762,-100,-2.6581605529
11363,3,長瀞町,7324,7908,-584,-7.3849266566,30.43,240.7,2648,2713,-65,-2.3958717287
11365,3,小鹿野町,12117,13436,-1319,-9.8169097946,171.26,70.8,4363,4503,-140,-3.1090384188
11369,3,東秩父村,2915,3348,-433,-12.9330943847,37.06,78.7,1028,1075,-47,-4.3720930233
11381,3,美里町,11207,11605,-398,-3.4295562258,33.41,335.4,3612,3550,62,1.7464788732
11383,3,神川町,13730,14470,-740,-5.1140290256,47.4,289.7,5033,5001,32,0.6398720256
11385,3,上里町,30565,30998,-433,-1.3968643138,29.18,1047.5,11225,10887,338,3.1046201892
11408,3,寄居町,34081,35774,-1693,-4.7324872813,64.25,530.4,12934,12694,240,1.8906570033
11442,3,宮代町,33705,33641,64,0.1902440474,15.95,2113.2,13728,13190,538,4.0788476118
11464,3,杉戸町,45495,46923,-1428,-3.0432836775,30.03,1515,17348,16704,644,3.8553639847
11465,3,松伏町,30061,31153,-1092,-3.5052803903,16.2,1855.6,10702,10427,275,2.6373837154
12100,1,千葉市,971882,961749,10133,1.0536013035,271.76,3576.3,417857,406309,11548,2.8421718446
12101,0,千葉市 中央区,205070,199364,5706,2.8621014827,44.69,4588.7,95227,93614,1613,1.7230328797
12102,0,千葉市 花見川区,179200,180949,-1749,-0.9665706912,34.19,5241.3,77732,76051,1681,2.2103588381
12103,0,千葉市 稲毛区,160968,157768,3200,2.0282947112,21.22,7585.7,71334,68503,2831,4.1326657227
12104,0,千葉市 若葉区,151078,151585,-507,-0.3344658113,84.21,1794.1,62773,61484,1289,2.0964803851
12105,0,千葉市 緑区,126848,121921,4927,4.0411413948,66.25,1914.7,46792,44004,2788,6.3357876557
12106,0,千葉市 美浜区,148718,150162,-1444,-0.9616281083,21.2,7015,63999,62653,1346,2.1483408616
12202,2,銚子市,64415,70210,-5795,-8.2538099986,84.19,765.1,26234,27035,-801,-2.9628259663
12203,2,市川市,481732,473919,7813,1.648593958,57.45,8385.2,228845,220582,8263,3.7459992202
12204,2,船橋市,622890,609040,13850,2.2740706686,85.62,7275.1,272432,261415,11017,4.2143717843
12205,2,館山市,47464,49290,-1826,-3.7046053966,110.15,430.9,20146,20232,-86,-0.4250691973
12206,2,木更津市,134141,129312,4829,3.7343788666,138.95,965.4,54920,50042,4878,9.7478118381
12207,2,松戸市,483480,484457,-977,-0.2016690852,61.38,7876.8,215627,209570,6057,2.8902037505
12208,2,野田市,153583,155491,-1908,-1.227080667,103.55,1483.2,59712,58050,1662,2.8630490956
12210,2,茂原市,89688,93015,-3327,-3.5768424448,99.92,897.6,36026,35936,90,0.250445236
12211,2,成田市,131190,128933,2257,1.7505215887,213.84,613.5,55462,52894,2568,4.8549930049
12212,2,佐倉市,172739,172183,556,0.3229122503,103.69,1665.9,68696,65035,3661,5.6292765434
12213,2,東金市,60652,61751,-1099,-1.7797282635,89.12,680.6,25114,24378,736,3.019115596
12215,2,旭市,66586,69058,-2472,-3.5795997567,130.45,510.4,23350,23157,193,0.833441292
12216,2,習志野市,167909,164530,3379,2.0537288033,20.97,8007.1,72350,70132,2218,3.1626076541
12217,2,柏市,413954,404012,9942,2.4608179955,114.74,3607.8,175691,162287,13404,8.2594416065
12218,2,勝浦市,19248,20788,-1540,-7.4081200693,93.96,204.9,8965,9179,-214,-2.3314086502
12219,2,市原市,274656,280416,-5760,-2.0540910647,368.17,746,113518,111973,1545,1.3797969153
12220,2,流山市,174373,163984,10389,6.3353741828,35.32,4936.9,70802,64921,5881,9.0587021149
12221,2,八千代市,193152,189781,3371,1.7762578973,51.39,3758.6,78358,74824,3534,4.7230835026
12222,2,我孫子市,131606,134017,-2411,-1.7990254968,43.15,3050,54089,53170,919,1.728418281
12223,2,鴨川市,33932,35766,-1834,-5.1277749818,191.14,177.5,14453,14361,92,0.640623912
12224,2,鎌ケ谷市,108917,107853,1064,0.9865279594,21.08,5166.8,44101,41955,2146,5.1150041711
12225,2,君津市,86033,89168,-3135,-3.5158352772,318.81,269.9,34447,33908,539,1.5895953757
12226,2,富津市,45601,48073,-2472,-5.1421796019,205.53,221.9,17634,17311,323,1.8658656346
12227,2,浦安市,164024,164877,-853,-0.5173553619,17.3,9481.2,74229,71411,2818,3.946170758
12228,2,四街道市,89245,86726,2519,2.9045499619,34.52,2585.3,35014,32514,2500,7.6889955096
12229,2,袖ケ浦市,60952,60355,597,0.9891475437,94.93,642.1,22652,21561,1091,5.0600621493
12230,2,八街市,70734,73212,-2478,-3.3846910343,74.94,943.9,27074,25838,1236,4.7836519854
12231,2,印西市,92670,88176,4494,5.096624932,123.79,748.6,32590,29622,2968,10.0195800419
12232,2,白井市,61674,60345,1329,2.2023365648,35.48,1738.3,22725,21207,1518,7.1580138633
12233,2,富里市,49636,51087,-1451,-2.8402529019,53.88,921.2,20057,19701,356,1.8070148723
12234,2,南房総市,39033,42104,-3071,-7.2938438153,230.14,169.6,15061,15575,-514,-3.3001605136
12235,2,匝瑳市,37261,39814,-2553,-6.4123172753,101.52,367,12712,12873,-161,-1.2506797172
12236,2,香取市,77499,82866,-5367,-6.4767214539,262.35,295.4,27294,27309,-15,-0.0549269472
12237,2,山武市,52222,56089,-3867,-6.8943999715,146.77,355.8,19454,19286,168,0.871098206
12238,2,いすみ市,38594,40962,-2368,-5.7809677262,157.44,245.1,14849,14704,145,0.9861262242
12239,2,大網白里市,49184,50113,-929,-1.8538103885,58.08,846.8,18849,18135,714,3.9371381307
12322,3,酒々井町,20955,21234,-279,-1.3139304888,19.01,1102.3,8970,8571,399,4.6552327616
12329,3,栄町,21228,22580,-1352,-5.9875996457,32.51,653,8185,8004,181,2.2613693153
12342,3,神崎町,6133,6454,-321,-4.9736597459,19.9,308.2,2207,2135,72,3.3723653396
12347,3,多古町,14724,16002,-1278,-7.9865016873,72.8,202.3,5053,5145,-92,-1.788143829
12349,3,東庄町,14152,15154,-1002,-6.612115613,46.25,306,4562,4561,1,0.0219250164
12403,3,九十九里町,16510,18004,-1494,-8.2981559653,24.45,675.3,6411,6621,-210,-3.1717263253
12409,3,芝山町,7431,7920,-489,-6.1742424242,43.24,171.9,2453,2470,-17,-0.6882591093
12410,3,横芝光町,23762,24675,-913,-3.7001013171,67.01,354.6,8433,8278,155,1.8724329548
12421,3,一宮町,11767,12034,-267,-2.2187136447,22.97,512.3,4485,4393,92,2.0942408377
12422,3,睦沢町,7222,7340,-118,-1.6076294278,35.59,202.9,2434,2400,34,1.4166666667
12423,3,長生村,14359,14752,-393,-2.6640455531,28.29,507.6,5178,5032,146,2.9014308426
12424,3,白子町,11149,12151,-1002,-8.2462348778,27.5,405.4,4164,4274,-110,-2.5737014506
12426,3,長柄町,7337,8035,-698,-8.6869943995,47.11,155.7,2591,2639,-48,-1.8188707844
12427,3,長南町,8206,9073,-867,-9.5558249752,65.51,125.3,2789,2816,-27,-0.9588068182
12441,3,大多喜町,9843,10671,-828,-7.759347765,129.87,75.8,3447,3584,-137,-3.8225446429
12443,3,御宿町,7315,7738,-423,-5.4665288188,24.86,294.2,3054,3109,-55,-1.7690575748
12463,3,鋸南町,8022,8950,-928,-10.3687150838,45.19,177.5,3327,3480,-153,-4.3965517241
13100,1,特別区部,9272740,8945695,327045,3.655892583,626.7,14796.1,4801194,4540746,260448,5.735797598
13101,0,千代田区,58406,47115,11291,23.9647670593,11.66,5009.1,33262,25560,7702,30.1330203443
13102,0,中央区,141183,122762,18421,15.0054577149,10.21,13827.9,79272,67981,11291,16.6090525294
13103,0,港区,243283,205131,38152,18.5988465907,20.37,11943.2,130562,110113,20449,18.5709225977
13104,0,新宿区,333560,326309,7251,2.2221268797,18.22,18307.4,204989,195434,9555,4.8891185771
13105,0,文京区,219724,206626,13098,6.338989285,11.29,19461.8,120858,111753,9105,8.1474322837
13106,0,台東区,198073,175928,22145,12.5875358101,10.11,19591.8,112117,95413,16704,17.5070483058
13107,0,墨田区,256274,247606,8668,3.5007229227,13.77,18611,130862,120797,10065,8.3321605669
13108,0,江東区,498109,460819,37290,8.0921142574,40.16,12403.1,243708,214424,29284,13.6570533149
13109,0,品川区,386855,365302,21553,5.9000498218,22.84,16937.6,212374,196132,16242,8.2811575877
13110,0,目黒区,277622,268330,9292,3.4629001603,14.67,18924.5,146162,138028,8134,5.8930072159
13111,0,大田区,717082,693373,23709,3.4193716802,60.66,11821.3,371149,345608,25541,7.3901645795
13112,0,世田谷区,903346,877138,26208,2.9878992815,58.05,15561.5,463632,448961,14671,3.2677671334
13113,0,渋谷区,224533,204492,20041,9.8003833891,15.11,14859.9,135749,123746,12003,9.6997074653
13114,0,中野区,328215,314750,13465,4.2779984114,15.59,21052.9,196132,184267,11865,6.4390259786
13115,0,杉並区,563997,549569,14428,2.6253300314,34.06,16558.9,312001,302805,9196,3.0369379634
13116,0,豊島区,291167,284678,6489,2.2794174471,13.01,22380.2,176376,166214,10162,6.1138050946
13117,0,北区,341076,335544,5532,1.6486660468,20.61,16549.1,178379,172568,5811,3.3673682259
13118,0,荒川区,212264,203296,8968,4.4113017472,10.16,20892.1,103101,96161,6940,7.2170630505
13119,0,板橋区,561916,535824,26092,4.8695093911,32.22,17440,291408,272683,18725,6.8669480679
13120,0,練馬区,721722,716124,5598,0.7817081958,48.08,15010.9,337987,336163,1824,0.5425939202
13121,0,足立区,670122,683426,-13304,-1.9466628428,53.25,12584.5,310662,314618,-3956,-1.2573978603
13122,0,葛飾区,442913,442586,327,0.0738839457,34.8,12727.4,201380,197276,4104,2.0803341511
13123,0,江戸川区,681298,678967,2331,0.3433156545,49.9,13653.3,309072,304041,5031,1.6547110423
13201,2,八王子市,577513,580053,-2540,-0.4378910203,186.38,3098.6,253356,249893,3463,1.3857931195
13202,2,立川市,176295,179668,-3373,-1.8773515595,24.36,7237.1,83285,80916,2369,2.9277275199
13203,2,武蔵野市,144730,138734,5996,4.3219398273,10.98,13181.2,74022,71228,2794,3.9226147021
13204,2,三鷹市,186936,186083,853,0.4583975968,16.42,11384.7,90226,90190,36,0.0399157335
13205,2,青梅市,137381,139339,-1958,-1.4052060084,103.31,1329.8,54371,52544,1827,3.4770858709
13206,2,府中市,260274,255506,4768,1.8661009918,29.43,8843.8,119569,115166,4403,3.8231769793
13207,2,昭島市,111539,112297,-758,-0.6749957701,17.34,6432.5,48258,47236,1022,2.1636040308
13208,2,調布市,229061,223593,5468,2.4455148417,21.58,10614.5,110581,107919,2662,2.4666648134
13209,2,町田市,432348,427016,5332,1.2486651554,71.8,6021.6,186711,180172,6539,3.6293097707
13210,2,小金井市,121396,118852,2544,2.1404772322,11.3,10743,59796,57695,2101,3.6415633937
13211,2,小平市,190005,187035,2970,1.5879380865,20.51,9264,82888,81784,1104,1.3498972904
13212,2,日野市,186283,180052,6231,3.4606669184,27.55,6761.6,84928,80138,4790,5.9771893484
13213,2,東村山市,149956,153557,-3601,-2.3450575356,17.14,8748.9,64604,63985,619,0.9674142377
13214,2,国分寺市,122742,120650,2092,1.7339411521,11.46,10710.5,59130,57775,1355,2.3453050627
13215,2,国立市,73655,75510,-1855,-2.4566282612,8.15,9037.4,34062,35767,-1705,-4.7669639612
13218,2,福生市,58395,59796,-1401,-2.3429660847,10.16,5747.5,27260,27045,215,0.7949713441
13219,2,狛江市,80249,78751,1498,1.9021980673,6.39,12558.5,39458,39168,290,0.7404003268
13220,2,東大和市,85157,83068,2089,2.514807146,13.42,6345.5,35555,33648,1907,5.6674988112
13221,2,清瀬市,74864,74104,760,1.0255856634,10.23,7318.1,32369,30954,1415,4.5712993474
13222,2,東久留米市,116632,116546,86,0.0737906063,12.88,9055.3,49902,49177,725,1.4742664254
13223,2,武蔵村山市,71229,70053,1176,1.6787289624,15.32,4649.4,28300,26790,1510,5.6364315043
13224,2,多摩市,146631,147648,-1017,-0.6888003901,21.01,6979.1,65461,64078,1383,2.1583070633
13225,2,稲城市,87636,84835,2801,3.3017033064,17.97,4876.8,36533,34842,1691,4.8533379255
13227,2,羽村市,55833,57032,-1199,-2.1023285173,9.9,5639.7,23451,23449,2,0.0085291484
13228,2,あきる野市,80954,80868,86,0.1063461443,73.47,1101.9,30817,29385,1432,4.8732346435
13229,2,西東京市,200012,196511,3501,1.7815796571,15.75,12699.2,89734,87457,2277,2.6035651806
13303,3,瑞穂町,33445,33497,-52,-0.1552377825,16.85,1984.9,13192,12369,823,6.6537311019
13305,3,日の出町,17446,16650,796,4.7807807808,28.07,621.5,5800,5461,339,6.2076542758
13307,3,檜原村,2209,2558,-349,-13.6434714621,105.41,21,839,915,-76,-8.306010929
13308,3,奥多摩町,5234,6045,-811,-13.4160463193,225.53,23.2,2045,2217,-172,-7.7582318448
13361,3,大島町,7884,8461,-577,-6.8195248789,90.76,86.9,3947,4098,-151,-3.6847242557
13362,3,利島村,337,341,-4,-1.1730205279,4.12,81.8,194,204,-10,-4.9019607843
13363,3,新島村,2749,2883,-134,-4.6479361776,27.54,99.8,1261,1251,10,0.7993605116
13364,3,神津島村,1891,1889,2,0.1058761249,18.58,101.8,791,787,4,0.5082592122
13381,3,三宅村,2482,2676,-194,-7.2496263079,55.27,44.9,1483,1578,-95,-6.020278834
13382,3,御蔵島村,335,348,-13,-3.7356321839,20.54,16.3,194,198,-4,-2.0202020202
13401,3,八丈町,7613,8231,-618,-7.5082007047,72.23,105.4,3913,4090,-177,-4.3276283619
13402,3,青ヶ島村,178,201,-23,-11.4427860697,5.96,29.9,125,122,3,2.4590163934
13421,3,小笠原村,3022,2785,237,8.5098743268,104.35,29,1517,1344,173,12.8720238095
14100,1,横浜市,3724844,3688773,36071,0.9778590333,437.49,8514.1,1645618,1583889,61729,3.8973059349
14101,0,横浜市 鶴見区,285356,272178,13178,4.8416844859,33.23,8587.3,132814,124177,8637,6.9553943162
14102,0,横浜市 神奈川区,238966,233429,5537,2.3720274687,23.73,10070.2,119397,113613,5784,5.0909667028
14103,0,横浜市 西区,98532,94867,3665,3.8633033615,7.03,14015.9,51878,49076,2802,5.7095117777
14104,0,横浜市 中区,148312,146033,2279,1.5606061644,21.2,6995.8,78869,75700,3169,4.1862615588
14105,0,横浜市 南区,194827,196153,-1326,-0.6760029161,12.65,15401.3,95528,92352,3176,3.439015939
14106,0,横浜市 保土ケ谷区,205493,206634,-1141,-0.5521840549,21.93,9370.4,92775,90076,2699,2.9963586305
14107,0,横浜市 磯子区,166229,163237,2992,1.8329177821,19.05,8725.9,74552,71169,3383,4.753474125
14108,0,横浜市 金沢区,202229,209274,-7045,-3.3664000306,30.96,6531.9,86891,86773,118,0.1359870006
14109,0,横浜市 港北区,344172,329471,14701,4.462001208,31.4,10960.9,163519,154733,8786,5.6781681994
14110,0,横浜市 戸塚区,275283,274324,959,0.3495866202,35.79,7691.6,113421,109824,3597,3.2752403846
14111,0,横浜市 港南区,215736,221411,-5675,-2.5631066207,19.9,10841,91007,90108,899,0.9976916589
14112,0,横浜市 旭区,247144,251086,-3942,-1.5699800069,32.73,7551,102728,100980,1748,1.7310358487
14113,0,横浜市 緑区,180366,177631,2735,1.539708722,25.51,7070.4,74498,71204,3294,4.6261445986
14114,0,横浜市 瀬谷区,124560,126913,-2353,-1.8540259863,17.17,7254.5,50435,49560,875,1.7655367232
14115,0,横浜市 栄区,122171,124866,-2695,-2.1583137123,18.52,6596.7,50853,50345,508,1.0090376403
14116,0,横浜市 泉区,154025,155698,-1673,-1.0745160503,23.58,6532,60707,58838,1869,3.1765185764
14117,0,横浜市 青葉区,309692,304297,5395,1.7729389379,35.22,8793.1,125344,120378,4966,4.125338517
14118,0,横浜市 都筑区,211751,201271,10480,5.2069100864,27.87,7597.8,80402,74983,5419,7.2269714469
14130,1,川崎市,1475213,1425512,49701,3.4865367671,143,10316.2,691837,662694,29143,4.3976556299
14131,0,川崎市 川崎区,223378,217328,6050,2.7838106457,39.53,5650.8,109768,105586,4182,3.9607523725
14132,0,川崎市 幸区,160890,154212,6678,4.3304023033,10.01,16072.9,75160,70680,4480,6.3384267119
14133,0,川崎市 中原区,247529,233925,13604,5.8155391685,14.74,16793,123547,117190,6357,5.4245242768
14134,0,川崎市 高津区,228141,217360,10781,4.9599742363,16.36,13945,107931,101753,6178,6.0715654575
14135,0,川崎市 多摩区,214158,213894,264,0.123425622,20.5,10446.7,106472,103595,2877,2.7771610599
14136,0,川崎市 宮前区,225594,218867,6727,3.0735560866,18.61,12122.2,94808,92164,2644,2.8687990973
14137,0,川崎市 麻生区,175523,169926,5597,3.2937867072,23.25,7549.4,74151,71726,2425,3.3809218415
14150,1,相模原市,720780,717515,3265,0.4550427517,328.66,2193.1,311188,302802,8386,2.7694665161
14151,0,相模原市 緑区,173612,176192,-2580,-1.46431166,253.68,684.4,71182,70052,1130,1.6130874208
14152,0,相模原市 中央区,269888,266982,2906,1.0884628926,36.87,7320,116240,112483,3757,3.3400602758
14153,0,相模原市 南区,277280,274341,2939,1.0712944839,38.11,7275.8,123766,120267,3499,2.9093600073
14201,2,横須賀市,406586,418325,-11739,-2.8061913584,100.83,4032.4,165746,164362,1384,0.8420437814
14203,2,平塚市,258227,260780,-2553,-0.9789861186,67.82,3807.5,107397,104369,3028,2.9012446224
14204,2,鎌倉市,173019,174314,-1295,-0.7429122159,39.67,4361.5,73035,72463,572,0.7893683673
14205,2,藤沢市,423894,409657,14237,3.4753464484,69.57,6093.1,180170,171981,8189,4.7615724993
14206,2,小田原市,194086,198327,-4241,-2.1383876124,113.81,1705.4,79120,77793,1327,1.705809006
14207,2,茅ヶ崎市,239348,235081,4267,1.8151190441,35.7,6704.4,97951,93445,4506,4.8220878592
14208,2,逗子市,57425,58302,-877,-1.5042365614,17.28,3323.2,24103,23844,259,1.0862271431
14210,2,三浦市,45289,48352,-3063,-6.3347948379,32.05,1413.1,17567,17884,-317,-1.7725341087
14211,2,秦野市,167378,170145,-2767,-1.6262599547,103.76,1613.1,69778,69373,405,0.5838006141
14212,2,厚木市,225714,224420,1294,0.5765974512,93.84,2405.3,95824,92476,3348,3.6203988062
14213,2,大和市,232922,228186,4736,2.0754998116,27.09,8598.1,102020,97244,4776,4.9113569989
14214,2,伊勢原市,101514,101039,475,0.4701155,55.56,1827.1,43088,41184,1904,4.6231546232
14215,2,海老名市,130190,127707,2483,1.9442943613,26.59,4896.2,53416,50405,3011,5.9736137288
14216,2,座間市,128737,129436,-699,-0.5400352298,17.57,7327.1,55910,53977,1933,3.5811549364
14217,2,南足柄市,43306,44020,-714,-1.6219900045,77.12,561.5,16245,15873,372,2.3436023436
14218,2,綾瀬市,84460,83167,1293,1.5547031876,22.14,3814.8,33356,31519,1837,5.8282305911
14301,3,葉山町,32096,32766,-670,-2.0448025392,17.04,1883.6,12580,12539,41,0.326979823
14321,3,寒川町,47936,47672,264,0.553784192,13.34,3593.4,18744,18033,711,3.9427715854
14341,3,大磯町,31550,33032,-1482,-4.4865584887,17.18,1836.4,12279,12416,-137,-1.1034149485
14342,3,二宮町,28378,29522,-1144,-3.8750762143,9.08,3125.3,11183,11338,-155,-1.3670841418
14361,3,中井町,9679,10010,-331,-3.3066933067,19.99,484.2,3359,3339,20,0.5989817311
14362,3,大井町,17033,17972,-939,-5.2247941242,14.38,1184.5,6178,6350,-172,-2.7086614173
14363,3,松田町,11171,11676,-505,-4.3251113395,37.75,295.9,4406,4433,-27,-0.609068351
14364,3,山北町,10724,11764,-1040,-8.8405304318,224.61,47.7,3903,3954,-51,-1.2898330804
14366,3,開成町,17013,16369,644,3.9342659906,6.55,2597.4,6169,5749,420,7.3056183684
14382,3,箱根町,11786,13853,-2067,-14.9209557497,92.86,126.9,6088,7266,-1178,-16.2124965593
14383,3,真鶴町,7333,8212,-879,-10.7038480273,7.04,1041.6,3068,3252,-184,-5.6580565806
14384,3,湯河原町,25026,26848,-1822,-6.786352801,40.97,610.8,10763,11002,-239,-2.1723323032
14401,3,愛川町,40343,42089,-1746,-4.1483523011,34.28,1176.9,16067,16063,4,0.0249019486
14402,3,清川村,3214,3459,-245,-7.0829719572,71.24,45.1,1122,1201,-79,-6.5778517902
15100,1,新潟市,810157,811901,-1744,-0.2148045143,726.45,1115.2,321511,312533,8978,2.8726566475
15101,0,新潟市 北区,76328,77621,-1293,-1.6657863207,107.72,708.6,27070,26050,1020,3.915547025
15102,0,新潟市 東区,137577,138096,-519,-0.3758255127,38.62,3562.3,55550,54447,1103,2.0258232777
15103,0,新潟市 中央区,183767,180537,3230,1.7891069421,37.75,4868,88506,85405,3101,3.630934957
15104,0,新潟市 江南区,68906,69365,-459,-0.6617170043,75.42,913.6,23677,22963,714,3.1093498236
15105,0,新潟市 秋葉区,76843,77329,-486,-0.6284834926,95.38,805.7,26898,26141,757,2.8958341303
15106,0,新潟市 南区,45685,46949,-1264,-2.6922831157,100.91,452.7,14583,14113,470,3.3302628782
15107,0,新潟市 西区,162833,161264,1569,0.9729387836,94.09,1730.6,66860,65255,1605,2.4595816413
15108,0,新潟市 西蒲区,58218,60740,-2522,-4.1521238064,176.55,329.8,18367,18159,208,1.1454375241
15202,2,長岡市,275133,282674,-7541,-2.6677373936,891.06,308.8,100143,98725,1418,1.4363129906
15204,2,三条市,99192,102292,-3100,-3.0305400227,431.97,229.6,33201,32467,734,2.2607570764
15205,2,柏崎市,86833,91451,-4618,-5.0496987458,442.03,196.4,33560,34104,-544,-1.5951208069
15206,2,新発田市,98611,101202,-2591,-2.5602260825,533.1,185,34186,33445,741,2.2155778143
15208,2,小千谷市,36498,38600,-2102,-5.4455958549,155.19,235.2,12165,12267,-102,-0.831499144
15209,2,加茂市,27852,29762,-1910,-6.4175794637,133.72,208.3,9634,9677,-43,-0.4443525886
15210,2,十日町市,54917,58911,-3994,-6.7797185585,590.39,93,18598,18983,-385,-2.0281304325
15211,2,見附市,40608,41862,-1254,-2.9955568296,77.91,521.2,13702,13371,331,2.4755066936
15212,2,村上市,62442,66427,-3985,-5.9990666446,1174.26,53.2,22138,22058,80,0.3626802067
15213,2,燕市,79784,81876,-2092,-2.5550832967,110.96,719,27537,26653,884,3.3166998087
15216,2,糸魚川市,44162,47702,-3540,-7.4210724917,746.24,59.2,16699,17433,-734,-4.2104055527
15217,2,妙高市,33199,35457,-2258,-6.368277068,445.63,74.5,11562,11801,-239,-2.0252520973
15218,2,五泉市,51404,54550,-3146,-5.7671860678,351.91,146.1,16945,16859,86,0.5101132926
15222,2,上越市,196987,203899,-6912,-3.3899136337,973.81,202.3,71015,71477,-462,-0.6463617667
15223,2,阿賀野市,43415,45560,-2145,-4.7080772608,192.74,225.3,13390,13154,236,1.7941310628
15224,2,佐渡市,57255,62727,-5472,-8.7235161892,855.61,66.9,22401,23755,-1354,-5.6998526626
15225,2,魚沼市,37352,40361,-3009,-7.4552166696,946.76,39.5,12833,13075,-242,-1.8508604207
15226,2,南魚沼市,58568,61624,-3056,-4.9591068415,584.55,100.2,19426,19482,-56,-0.2874448209
15227,2,胎内市,30198,31424,-1226,-3.9014765784,264.89,114,10056,9901,155,1.5654984345
15307,3,聖籠町,14040,13724,316,2.3025357039,37.58,373.6,4262,3950,312,7.8987341772
15342,3,弥彦村,8209,8582,-373,-4.3463062223,25.17,326.1,2584,2586,-2,-0.0773395205
15361,3,田上町,12188,12791,-603,-4.7142522086,31.71,384.4,4028,4027,1,0.0248323814
15385,3,阿賀町,11680,13303,-1623,-12.2002555814,952.89,12.3,4482,4870,-388,-7.9671457906
15405,3,出雲崎町,4528,4907,-379,-7.7236600774,44.38,102,1608,1665,-57,-3.4234234234
15461,3,湯沢町,8046,8396,-350,-4.1686517389,357.29,22.5,3455,3463,-8,-0.231013572
15482,3,津南町,10029,10881,-852,-7.8301626689,170.21,58.9,3328,3482,-154,-4.4227455485
15504,3,刈羽村,4775,4800,-25,-0.5208333333,26.27,181.8,1682,1653,29,1.7543859649
15581,3,関川村,5832,6438,-606,-9.412861137,299.61,19.5,1846,1941,-95,-4.894384338
15586,3,粟島浦村,370,366,4,1.0928961749,9.78,37.8,173,182,-9,-4.9450549451
16201,2,富山市,418686,421953,-3267,-0.7742568485,1241.77,337.2,163862,159151,4711,2.9600819348
16202,2,高岡市,172125,176061,-3936,-2.2355888016,209.57,821.3,63814,61992,1822,2.9390889147
16204,2,魚津市,42935,44959,-2024,-4.5018794902,200.61,214,15855,15924,-69,-0.433308214
16205,2,氷見市,47992,51726,-3734,-7.2188067896,230.56,208.2,16096,16458,-362,-2.1995382185
16206,2,滑川市,32755,33676,-921,-2.7348853783,54.63,599.6,11699,11298,401,3.5493007612
16207,2,黒部市,40991,41852,-861,-2.0572493549,426.31,96.2,14793,14628,165,1.127973749
16208,2,砺波市,49000,49410,-410,-0.8297915402,127.03,385.7,16220,15559,661,4.2483450093
16209,2,小矢部市,30399,32067,-1668,-5.2016091309,134.07,226.7,9517,9581,-64,-0.6679887277
16210,2,南砺市,51327,54724,-3397,-6.2075140706,668.64,76.8,16594,16930,-336,-1.9846426462
16211,2,射水市,92308,93588,-1280,-1.3676967133,109.43,843.5,32115,31246,869,2.781155988
16321,3,舟橋村,2982,2967,15,0.5055611729,3.47,859.4,910,889,21,2.3622047244
16322,3,上市町,20930,21965,-1035,-4.7120418848,236.71,88.4,7395,7415,-20,-0.2697235334
16323,3,立山町,26317,27466,-1149,-4.1833539649,307.29,85.6,9159,8992,167,1.8572064057
16342,3,入善町,25335,27182,-1847,-6.7949378265,71.25,355.6,8628,8658,-30,-0.3465003465
16343,3,朝日町,12246,13651,-1405,-10.2922862794,226.3,54.1,4514,4718,-204,-4.3238660449
17201,2,金沢市,465699,462361,3338,0.721946704,468.64,993.7,199572,191256,8316,4.3480988832
17202,2,七尾市,55325,57900,-2575,-4.4473229706,318.32,173.8,20855,20944,-89,-0.4249427044
17203,2,小松市,106919,108433,-1514,-1.3962539079,371.05,288.2,38166,37470,696,1.8574859888
17204,2,輪島市,27216,29858,-2642,-8.8485498024,426.32,63.8,10649,11366,-717,-6.3082878761
17205,2,珠洲市,14625,16300,-1675,-10.2760736196,247.2,59.2,5861,6228,-367,-5.8927424534
17206,2,加賀市,67186,71887,-4701,-6.5394299387,305.87,219.7,24841,25966,-1125,-4.3325887699
17207,2,羽咋市,21729,23032,-1303,-5.6573463008,81.85,265.5,8066,8085,-19,-0.2350030921
17209,2,かほく市,34219,34651,-432,-1.2467172665,64.44,531,11604,11084,520,4.691447131
17210,2,白山市,109287,110459,-1172,-1.0610271685,754.93,144.8,38439,36556,1883,5.1510012036
17211,2,能美市,48881,48680,201,0.4129005752,84.14,580.9,17352,15945,1407,8.8240827846
17212,2,野々市市,55099,51885,3214,6.1944685362,13.56,4063.3,24759,23024,1735,7.5356150104
17324,3,川北町,6347,6147,200,3.2536196519,14.64,433.5,1853,1720,133,7.7325581395
17361,3,津幡町,36968,36940,28,0.0757985923,110.59,334.3,12545,11942,603,5.0494054597
17365,3,内灘町,26987,26927,60,0.2228246741,20.33,1327.4,10446,10018,428,4.2723098423
17384,3,志賀町,20422,22216,-1794,-8.0752610731,246.76,82.8,7493,7849,-356,-4.5356096318
17386,3,宝達志水町,13174,14277,-1103,-7.7257126847,111.52,118.1,4447,4561,-114,-2.4994518746
17407,3,中能登町,17571,18535,-964,-5.2009711357,89.45,196.4,6055,6133,-78,-1.2718082504
17461,3,穴水町,8786,9735,-949,-9.7483307653,183.21,48,3461,3659,-198,-5.4113145668
17463,3,能登町,17568,19565,-1997,-10.2070023,273.27,64.3,6904,7364,-460,-6.2466051059
18201,2,福井市,265904,266796,-892,-0.3343378461,536.41,495.7,99872,97446,2426,2.4895839747
18202,2,敦賀市,66165,67760,-1595,-2.3538961039,251.39,263.2,26545,26453,92,0.3477866405
18204,2,小浜市,29670,31340,-1670,-5.328653478,233.09,127.3,11220,11477,-257,-2.239261131
18205,2,大野市,33109,35291,-2182,-6.1828794877,872.43,38,10698,10847,-149,-1.3736517009
18206,2,勝山市,24125,25466,-1341,-5.2658446556,253.88,95,7703,7773,-70,-0.900553197
18207,2,鯖江市,68284,67450,834,1.2364714603,84.59,807.2,22335,21028,1307,6.2155221609
18208,2,あわら市,28729,29989,-1260,-4.2015405649,116.98,245.6,9697,9735,-38,-0.3903441192
18209,2,越前市,81524,85614,-4090,-4.7772560563,230.7,353.4,27889,27601,288,1.0434404551
18210,2,坂井市,90280,91900,-1620,-1.7627856366,209.67,430.6,29454,28744,710,2.4700807125
18322,3,永平寺町,19883,20647,-764,-3.7002954424,94.43,210.6,7276,7217,59,0.8175142026
18382,3,池田町,2638,3046,-408,-13.3946158897,194.65,13.6,902,1006,-104,-10.337972167
18404,3,南越前町,10799,11551,-752,-6.510258852,343.69,31.4,3353,3483,-130,-3.7324145851
18423,3,越前町,21538,23160,-1622,-7.0034542314,153.15,140.6,6560,6728,-168,-2.4970273484
18442,3,美浜町,9914,10563,-649,-6.1440878538,152.35,65.1,3899,3879,20,0.5155968033
18481,3,高浜町,10596,11062,-466,-4.2126197794,72.4,146.4,4191,4044,147,3.6350148368
18483,3,おおい町,8325,8580,-255,-2.972027972,212.19,39.2,3222,3144,78,2.4809160305
18501,3,若狭町,15257,16099,-842,-5.2301385179,178.49,85.5,4871,4994,-123,-2.4629555467
19201,2,甲府市,193125,198992,-5867,-2.9483597331,212.47,909,85057,85101,-44,-0.0517032702
19202,2,富士吉田市,49003,50619,-1616,-3.1924771331,121.74,402.5,18091,17713,378,2.1340258567
19204,2,都留市,32002,33588,-1586,-4.7219244968,161.63,198,13465,13536,-71,-0.5245271868
19205,2,山梨市,35141,36832,-1691,-4.5911164205,289.8,121.3,12961,13039,-78,-0.5982053838
19206,2,大月市,25419,28120,-2701,-9.6052631579,280.25,90.7,9804,10151,-347,-3.4183824254
19207,2,韮崎市,30680,32477,-1797,-5.5331465345,143.69,213.5,11673,11826,-153,-1.2937595129
19208,2,南アルプス市,70828,72635,-1807,-2.4877813726,264.14,268.1,25135,24500,635,2.5918367347
19209,2,北杜市,45111,46968,-1857,-3.9537557486,602.48,74.9,18408,18281,127,0.694710355
19210,2,甲斐市,74386,73807,579,0.784478437,71.95,1033.9,29463,28207,1256,4.4527954054
19211,2,笛吹市,69559,70529,-970,-1.37532079,201.92,344.5,26268,25500,768,3.0117647059
19212,2,上野原市,24805,27114,-2309,-8.5158958472,170.57,145.4,9661,10032,-371,-3.6981658692
19213,2,甲州市,31671,33927,-2256,-6.649571138,264.11,119.9,11389,11588,-199,-1.7172937522
19214,2,中央市,31124,31322,-198,-0.6321435413,31.69,982.1,12789,12179,610,5.0086213975
19346,3,市川三郷町,15673,17111,-1438,-8.403950675,75.18,208.5,5885,6074,-189,-3.1116233125
19364,3,早川町,1068,1246,-178,-14.2857142857,369.96,2.9,573,681,-108,-15.859030837
19365,3,身延町,12669,14462,-1793,-12.3980085742,301.98,42,5211,5593,-382,-6.829966029
19366,3,南部町,8067,9011,-944,-10.4760847853,200.87,40.2,3006,3088,-82,-2.6554404145
19368,3,富士川町,15294,16307,-1013,-6.2120561722,112,136.6,5673,5769,-96,-1.6640665627
19384,3,昭和町,19505,17653,1852,10.4911346513,9.08,2148.1,8223,7162,1061,14.8142976822
19422,3,道志村,1743,1919,-176,-9.1714434601,79.68,21.9,591,588,3,0.5102040816
19423,3,西桂町,4342,4541,-199,-4.3822946488,15.22,285.3,1478,1443,35,2.4255024255
19424,3,忍野村,8968,8635,333,3.8563983787,25.05,358,3034,2802,232,8.2798001428
19425,3,山中湖村,5208,5324,-116,-2.1788129226,53.05,98.2,1855,1763,92,5.2183777652
19429,3,鳴沢村,2921,2964,-43,-1.4507422402,89.58,32.6,1036,1015,21,2.0689655172
19430,3,富士河口湖町,25329,25471,-142,-0.557496761,158.4,159.9,9616,9409,207,2.2000212562
19442,3,小菅村,726,816,-90,-11.0294117647,52.78,13.8,337,347,-10,-2.8818443804
19443,3,丹波山村,563,685,-122,-17.8102189781,101.3,5.6,294,334,-40,-11.9760479042
20201,2,長野市,377598,381511,-3913,-1.0256585,834.81,452.3,150414,146520,3894,2.6576576577
20202,2,松本市,243293,243037,256,0.1053337558,978.47,248.6,100173,97303,2870,2.9495493459
20203,2,上田市,156827,159597,-2770,-1.7356215969,552.04,284.1,62696,60660,2036,3.3564127926
20204,2,岡谷市,50128,52841,-2713,-5.1342707367,85.1,589,19100,19501,-401,-2.0563048049
20205,2,飯田市,101581,105335,-3754,-3.5638676603,658.66,154.2,37694,37867,-173,-0.4568621755
20206,2,諏訪市,50140,51200,-1060,-2.0703125,109.17,459.3,20401,20444,-43,-0.2103306594
20207,2,須坂市,50725,52168,-1443,-2.7660634872,149.67,338.9,18447,18106,341,1.8833535844
20208,2,小諸市,42512,43997,-1485,-3.3752301293,98.55,431.4,16662,16343,319,1.9519060148
20209,2,伊那市,68271,71093,-2822,-3.9694484689,667.93,102.2,26231,26112,119,0.4557291667
20210,2,駒ヶ根市,32759,33693,-934,-2.772089158,165.86,197.5,12437,12161,276,2.2695502015
20211,2,中野市,43909,45638,-1729,-3.7885095754,112.18,391.4,15296,15092,204,1.351709515
20212,2,大町市,28041,29801,-1760,-5.9058420858,565.15,49.6,10826,11054,-228,-2.0626017731
20213,2,飯山市,21438,23545,-2107,-8.9488214058,202.43,105.9,7423,7694,-271,-3.5222251105
20214,2,茅野市,55912,56391,-479,-0.8494263269,266.59,209.7,22301,21687,614,2.8311891917
20215,2,塩尻市,67135,67670,-535,-0.7906014482,289.98,231.5,26350,25092,1258,5.0135501355
20217,2,佐久市,99368,100552,-1184,-1.1775001989,423.51,234.6,38487,37032,1455,3.9290343487
20218,2,千曲市,60298,62068,-1770,-2.8517110266,119.79,503.4,21573,21449,124,0.5781155299
20219,2,東御市,30107,30696,-589,-1.9188167839,112.37,267.9,11004,10801,203,1.879455606
20220,2,安曇野市,95282,96479,-1197,-1.2406845013,331.78,287.2,34732,34185,547,1.6001170104
20303,3,小海町,4713,5180,-467,-9.0154440154,114.2,41.3,1873,1843,30,1.6277807922
20304,3,川上村,4607,4972,-365,-7.3411102172,209.61,22,1205,1336,-131,-9.8053892216
20305,3,南牧村,3408,3528,-120,-3.4013605442,133.09,25.6,1036,1005,31,3.0845771144
20306,3,南相木村,1005,1121,-116,-10.3479036574,66.05,15.2,428,433,-5,-1.1547344111
20307,3,北相木村,774,842,-68,-8.0760095012,56.32,13.7,333,331,2,0.6042296073
20309,3,佐久穂町,11186,12069,-883,-7.3162648107,188.15,59.5,4014,4092,-78,-1.9061583578
20321,3,軽井沢町,18994,19018,-24,-0.1261962351,156.03,121.7,8247,8082,165,2.0415738679
20323,3,御代田町,15184,14738,446,3.0261907993,58.79,258.3,6118,5623,495,8.8031300018
20324,3,立科町,7265,7707,-442,-5.735046062,66.87,108.6,2682,2672,10,0.374251497
20349,3,青木村,4343,4609,-266,-5.7713169885,57.1,76.1,1556,1563,-7,-0.4478566859
20350,3,長和町,6166,6780,-614,-9.0560471976,183.86,33.5,2416,2468,-52,-2.1069692058
20361,3,下諏訪町,20236,21532,-1296,-6.0189485417,66.87,302.6,7946,8361,-415,-4.9635211099
20362,3,富士見町,14493,15338,-845,-5.5091928543,144.76,100.1,5396,5634,-238,-4.2243521477
20363,3,原村,7566,7573,-7,-0.0924336458,43.26,174.9,2673,2568,105,4.0887850467
20382,3,辰野町,19770,20909,-1139,-5.4474149888,169.2,116.8,7343,7356,-13,-0.1767264818
20383,3,箕輪町,25241,26214,-973,-3.7117570764,85.91,293.8,9240,9112,128,1.4047410009
20384,3,飯島町,9530,9902,-372,-3.7568168047,86.96,109.6,3325,3242,83,2.5601480568
20385,3,南箕輪村,15063,14543,520,3.5756033831,40.99,367.5,5839,5560,279,5.0179856115
20386,3,中川村,4850,5074,-224,-4.4146629878,77.05,62.9,1584,1576,8,0.5076142132
20388,3,宮田村,8821,8974,-153,-1.7049253399,54.5,161.9,3122,3092,30,0.9702457956
20402,3,松川町,13167,13676,-509,-3.7218484937,72.79,180.9,4355,4287,68,1.5861908094
20403,3,高森町,13080,13216,-136,-1.0290556901,45.36,288.4,4247,4157,90,2.165022853
20404,3,阿南町,4962,5455,-493,-9.0375802016,123.07,40.3,1737,1793,-56,-3.123257111
20407,3,阿智村,6538,7036,-498,-7.077885162,214.43,30.5,2188,2301,-113,-4.9109083007
20409,3,平谷村,484,563,-79,-14.0319715808,77.37,6.3,211,229,-18,-7.8602620087
20410,3,根羽村,970,1129,-159,-14.0832595217,89.97,10.8,416,450,-34,-7.5555555556
20411,3,下條村,3851,4200,-349,-8.3095238095,38.12,101,1159,1189,-30,-2.5231286796
20412,3,売木村,575,656,-81,-12.3475609756,43.43,13.2,270,288,-18,-6.25
20413,3,天龍村,1365,1657,-292,-17.6222088111,109.44,12.5,651,737,-86,-11.6689280868
20414,3,泰阜村,1702,1910,-208,-10.890052356,64.59,26.4,639,657,-18,-2.7397260274
20415,3,喬木村,6310,6692,-382,-5.708308428,66.61,94.7,2029,2058,-29,-1.4091350826
20416,3,豊丘村,6592,6819,-227,-3.3289338613,76.79,85.8,2054,2000,54,2.7
20417,3,大鹿村,1023,1160,-137,-11.8103448276,248.28,4.1,475,531,-56,-10.5461393597
20422,3,上松町,4670,5245,-575,-10.962821735,168.42,27.7,1864,2029,-165,-8.1320847708
20423,3,南木曽町,4313,4810,-497,-10.3326403326,215.93,20,1713,1830,-117,-6.393442623
20425,3,木祖村,2926,3134,-208,-6.636885769,140.5,20.8,1045,1069,-24,-2.2450888681
20429,3,王滝村,839,965,-126,-13.0569948187,310.82,2.7,398,414,-16,-3.8647342995
20430,3,大桑村,3825,4145,-320,-7.7201447527,234.47,16.3,1522,1537,-15,-0.9759271308
20432,3,木曽町,11826,12743,-917,-7.196107667,476.03,24.8,4942,5070,-128,-2.5246548323
20446,3,麻績村,2788,2970,-182,-6.1279461279,34.38,81.1,1001,1011,-10,-0.9891196835
20448,3,生坂村,1843,1953,-110,-5.6323604711,39.05,47.2,698,732,-34,-4.6448087432
20450,3,山形村,8395,8425,-30,-0.3560830861,24.98,336.1,2725,2601,124,4.7673971549
20451,3,朝日村,4462,4741,-279,-5.8848344231,70.62,63.2,1412,1422,-10,-0.7032348805
20452,3,筑北村,4730,5172,-442,-8.5460170147,99.47,47.6,1780,1839,-59,-3.2082653616
20481,3,池田町,9926,10329,-403,-3.90163617,40.16,247.2,3518,3510,8,0.2279202279
20482,3,松川村,9948,10093,-145,-1.4366392549,47.07,211.3,3497,3386,111,3.2782043709
20485,3,白馬村,8929,9205,-276,-2.9983704508,189.36,47.2,3477,3245,232,7.1494607088
20486,3,小谷村,2904,3221,-317,-9.8416640795,267.91,10.8,1195,1250,-55,-4.4
20521,3,坂城町,14871,15730,-859,-5.4609027336,53.64,277.2,5473,5505,-32,-0.5812897366
20541,3,小布施町,10702,11072,-370,-3.3417630058,19.12,559.7,3528,3511,17,0.4841925377
20543,3,高山村,7033,7563,-530,-7.0078011371,98.56,71.4,2291,2288,3,0.1311188811
20561,3,山ノ内町,12429,13678,-1249,-9.1314519667,265.9,46.7,4465,4666,-201,-4.3077582512
20562,3,木島平村,4658,4939,-281,-5.6894108119,99.32,46.9,1564,1560,4,0.2564102564
20563,3,野沢温泉村,3479,3853,-374,-9.7067220348,57.96,60,1159,1221,-62,-5.0778050778
20583,3,信濃町,8469,9238,-769,-8.3243126218,149.3,56.7,3157,3247,-90,-2.771789344
20588,3,小川村,2665,3041,-376,-12.364353831,58.11,45.9,1086,1152,-66,-5.7291666667
20590,3,飯綱町,11063,11865,-802,-6.7593763169,75,147.5,3769,3788,-19,-0.5015839493
20602,3,栄村,1953,2215,-262,-11.8284424379,271.66,7.2,775,849,-74,-8.7161366313
21201,2,岐阜市,406735,413136,-6401,-1.5493687309,203.6,1997.7,165443,161718,3725,2.3033923249
21202,2,大垣市,159879,161160,-1281,-0.7948622487,206.57,774,60085,58536,1549,2.6462347957
21203,2,高山市,89182,92747,-3565,-3.8437900956,2177.61,41,32670,32213,457,1.4186818986
21204,2,多治見市,110441,112595,-2154,-1.9130512012,91.25,1210.3,41446,40200,1246,3.0995024876
21205,2,関市,89153,91418,-2265,-2.477630226,472.33,188.8,32827,32212,615,1.9092263753
21206,2,中津川市,78883,80910,-2027,-2.50525275,676.45,116.6,28438,27885,553,1.9831450601
21207,2,美濃市,20760,22629,-1869,-8.2593132706,117.01,177.4,7508,7743,-235,-3.0349993543
21208,2,瑞浪市,38730,40387,-1657,-4.1028053582,174.86,221.5,13904,13597,307,2.2578509965
21209,2,羽島市,67337,67197,140,0.2083426343,53.66,1254.9,23948,22707,1241,5.4652750253
21210,2,恵那市,51073,53718,-2645,-4.9238616479,504.24,101.3,18106,18140,-34,-0.1874310915
21211,2,美濃加茂市,55384,54729,655,1.1968060809,74.81,740.3,20501,19801,700,3.5351749912
21212,2,土岐市,57827,60475,-2648,-4.3786688714,116.02,498.4,21039,20760,279,1.3439306358
21213,2,各務原市,144690,145604,-914,-0.6277300074,87.81,1647.8,53470,51961,1509,2.9041011528
21214,2,可児市,98695,97436,1259,1.2921302188,87.57,1127,37171,34768,2403,6.9115278417
21215,2,山県市,27114,29629,-2515,-8.4883053765,221.98,122.1,9640,9731,-91,-0.935155688
21216,2,瑞穂市,54354,51950,2404,4.6275264678,28.19,1928.1,21011,19376,1635,8.4382741536
21217,2,飛騨市,24696,26732,-2036,-7.6163399671,792.53,31.2,8509,8770,-261,-2.976054732
21218,2,本巣市,33995,35047,-1052,-3.0016834536,374.65,90.7,11346,11150,196,1.7578475336
21219,2,郡上市,42090,44491,-2401,-5.3965970646,1030.75,40.8,14610,14622,-12,-0.0820681165
21220,2,下呂市,33585,36314,-2729,-7.5150079859,851.21,39.5,12140,12496,-356,-2.8489116517
21221,2,海津市,35206,37941,-2735,-7.20856066,112.03,314.3,11513,11645,-132,-1.1335337055
21302,3,岐南町,24622,23804,818,3.4363972442,7.91,3112.8,9560,8971,589,6.5656002675
21303,3,笠松町,22750,22809,-59,-0.2586698233,10.3,2208.7,8191,7840,351,4.4770408163
21341,3,養老町,29029,31332,-2303,-7.3503127793,72.29,401.6,9378,9536,-158,-1.6568791946
21361,3,垂井町,27556,28505,-949,-3.3292404841,57.09,482.7,9374,9245,129,1.3953488372
21362,3,関ケ原町,7419,8096,-677,-8.3621541502,49.28,150.5,2625,2720,-95,-3.4926470588
21381,3,神戸町,19282,20065,-783,-3.9023174682,18.78,1026.7,6572,6511,61,0.9368760559
21382,3,輪之内町,9973,10028,-55,-0.5484643,22.33,446.6,3138,3015,123,4.07960199
21383,3,安八町,14752,15271,-519,-3.398598651,18.16,812.3,4713,4902,-189,-3.8555691554
21401,3,揖斐川町,21503,23784,-2281,-9.5904809956,803.44,26.8,7269,7742,-473,-6.1095324206
21403,3,大野町,23453,23859,-406,-1.7016639423,34.2,685.8,7366,7231,135,1.8669616927
21404,3,池田町,24347,24980,-633,-2.5340272218,38.8,627.5,7897,7801,96,1.2306114601
21421,3,北方町,18169,18395,-226,-1.2285947268,5.18,3507.5,7139,6925,214,3.0902527076
21501,3,坂祝町,8202,8361,-159,-1.9016864011,12.87,637.3,3111,3083,28,0.9082062926
21502,3,富加町,5564,5516,48,0.8701957941,16.82,330.8,1834,1741,93,5.3417576106
21503,3,川辺町,10197,10593,-396,-3.738317757,41.16,247.7,3561,3507,54,1.5397775877
21504,3,七宗町,3876,4484,-608,-13.5593220339,90.47,42.8,1381,1457,-76,-5.2161976664
21505,3,八百津町,11027,12045,-1018,-8.4516396845,128.79,85.6,3892,3999,-107,-2.6756689172
21506,3,白川町,8392,9530,-1138,-11.9412381952,237.9,35.3,3002,3123,-121,-3.874479667
21507,3,東白川村,2261,2514,-253,-10.0636435959,87.09,26,817,837,-20,-2.3894862605
21521,3,御嵩町,18111,18824,-713,-3.7877178071,56.69,319.5,6514,6333,181,2.8580451603
21604,3,白川村,1609,1733,-124,-7.1552221581,356.64,4.5,553,601,-48,-7.9866888519
22100,1,静岡市,704989,716197,-11208,-1.5649325535,1411.9,499.3,286013,279019,6994,2.5066393328
22101,0,静岡市 葵区,253593,255375,-1782,-0.6977973568,1073.76,236.2,101673,98767,2906,2.9422782913
22102,0,静岡市 駿河区,212419,213059,-640,-0.300386278,73.05,2907.9,90631,87433,3198,3.6576578637
22103,0,静岡市 清水区,238977,247763,-8786,-3.5461307782,265.09,901.5,93709,92819,890,0.9588554068
22130,1,浜松市,797980,800866,-2886,-0.3603599104,1558.06,512.2,309227,300444,8783,2.9233401233
22131,0,浜松市 中区,237443,238477,-1034,-0.4335847901,44.34,5355.1,106191,103707,2484,2.3952095808
22132,0,浜松市 東区,128555,126609,1946,1.537015536,46.29,2777.2,50106,47647,2459,5.160870569
22133,0,浜松市 西区,111353,113654,-2301,-2.0245657874,114.71,970.7,38730,38359,371,0.9671784979
22134,0,浜松市 南区,100870,102381,-1511,-1.4758597787,46.84,2153.5,38259,37517,742,1.9777700776
22135,0,浜松市 北区,93567,94680,-1113,-1.1755386565,295.54,316.6,32017,31430,587,1.8676423799
22136,0,浜松市 浜北区,95900,91108,4792,5.2596917944,66.5,1442.1,32493,29695,2798,9.4224616939
22137,0,浜松市 天竜区,30292,33957,-3665,-10.7930618135,943.84,32.1,11431,12089,-658,-5.4429646786
22203,2,沼津市,195633,202304,-6671,-3.2975126542,186.96,1046.4,80798,79616,1182,1.4846262058
22205,2,熱海市,37544,39611,-2067,-5.2182474565,61.78,607.7,18846,19740,-894,-4.5288753799
22206,2,三島市,110046,111838,-1792,-1.602317638,62.02,1774.4,45218,44620,598,1.3402061856
22207,2,富士宮市,130770,132001,-1231,-0.9325686927,389.08,336.1,49004,46988,2016,4.290457138
22208,2,伊東市,68345,71437,-3092,-4.3282892619,124.1,550.7,30478,30636,-158,-0.5157331244
22209,2,島田市,98112,100276,-2164,-2.1580437991,315.7,310.8,34310,33280,1030,3.0949519231
22210,2,富士市,248399,254027,-5628,-2.2155125243,244.95,1014.1,92581,90980,1601,1.7597274126
22211,2,磐田市,167210,168625,-1415,-0.8391401038,163.45,1023,61346,59414,1932,3.2517588447
22212,2,焼津市,139462,143249,-3787,-2.6436484722,70.31,1983.5,50648,49299,1349,2.7363638208
22213,2,掛川市,114602,116363,-1761,-1.5133676512,265.69,431.3,41050,39497,1553,3.9319441983
22214,2,藤枝市,143605,142151,1454,1.0228559771,194.06,740,52315,49658,2657,5.3505980909
22215,2,御殿場市,88078,89030,-952,-1.0693024823,194.9,451.9,31610,31403,207,0.6591726905
22216,2,袋井市,85789,84846,943,1.111425406,108.33,791.9,31453,29791,1662,5.5788661005
22219,2,下田市,22916,25013,-2097,-8.3836405069,104.38,219.5,10397,10794,-397,-3.6779692422
22220,2,裾野市,52737,54546,-1809,-3.3164668353,138.12,381.8,20792,21042,-250,-1.1880999905
22221,2,湖西市,59789,60107,-318,-0.5290565159,86.56,690.7,22546,21619,927,4.2878949073
22222,2,伊豆市,31317,34202,-2885,-8.4351792293,363.97,86,12158,12583,-425,-3.3775729158
22223,2,御前崎市,32578,34700,-2122,-6.1152737752,65.56,496.9,11345,11494,-149,-1.2963285192
22224,2,菊川市,46763,47041,-278,-0.5909738313,94.19,496.5,16095,15485,610,3.939296093
22225,2,伊豆の国市,48152,49269,-1117,-2.2671456697,94.62,508.9,18677,18742,-65,-0.3468146409
22226,2,牧之原市,45547,49019,-3472,-7.0829678288,111.69,407.8,15416,15607,-191,-1.2238098289
22301,3,東伊豆町,12624,14064,-1440,-10.2389078498,77.81,162.2,5620,5988,-368,-6.1456245825
22302,3,河津町,7303,7998,-695,-8.6896724181,100.69,72.5,2919,3029,-110,-3.6315615715
22304,3,南伊豆町,8524,9516,-992,-10.4245481295,109.94,77.5,3435,3710,-275,-7.4123989218
22305,3,松崎町,6837,7653,-816,-10.6624852999,85.19,80.3,2832,3018,-186,-6.1630218688
22306,3,西伊豆町,8234,9469,-1235,-13.0425599324,105.54,78,3673,4030,-357,-8.858560794
22325,3,函南町,37661,38571,-910,-2.3592854735,65.16,578,14317,13993,324,2.315443436
22341,3,清水町,32118,32302,-184,-0.5696241719,8.81,3645.6,12363,12180,183,1.5024630542
22342,3,長泉町,42331,40763,1568,3.8466256164,26.63,1589.6,16427,15512,915,5.8986591026
22344,3,小山町,19497,20629,-1132,-5.4874206215,135.74,143.6,6431,6564,-133,-2.0262035344
22424,3,吉田町,29093,29815,-722,-2.4215998658,20.73,1403.4,10244,10253,-9,-0.0877791866
22429,3,川根本町,7192,8074,-882,-10.9239534308,496.88,14.5,2883,2986,-103,-3.4494306765
22461,3,森町,18528,19435,-907,-4.6668381785,133.91,138.4,6133,6126,7,0.1142670584
23100,1,名古屋市,2295638,2263894,31744,1.4021857914,326.45,7032.1,1058497,1021227,37270,3.649531397
23101,0,名古屋市 千種区,164696,160015,4681,2.9253507484,18.18,9059.2,85028,80411,4617,5.7417517504
23102,0,名古屋市 東区,78043,73272,4771,6.5113549514,7.71,10122.3,41311,38562,2749,7.1287796276
23103,0,名古屋市 北区,163579,165785,-2206,-1.3306390807,17.53,9331.4,75428,74641,787,1.0543803004
23104,0,名古屋市 西区,149098,144995,4103,2.8297527501,17.93,8315.6,70078,66133,3945,5.965251841
23105,0,名古屋市 中村区,133206,136164,-2958,-2.1723803649,16.3,8172.1,66039,68877,-2838,-4.1203885187
23106,0,名古屋市 中区,83203,78353,4850,6.1899352928,9.38,8870.3,53533,50000,3533,7.066
23107,0,名古屋市 昭和区,107170,105536,1634,1.5482868405,10.94,9796.2,55108,53782,1326,2.4655089063
23108,0,名古屋市 瑞穂区,105357,105061,296,0.2817410838,11.22,9390.1,48629,47826,803,1.6790030527
23109,0,名古屋市 熱田区,65895,64719,1176,1.8170861725,8.2,8036,31884,30098,1786,5.9339490996
23110,0,名古屋市 中川区,220281,221521,-1240,-0.5597663427,32.02,6879.5,95495,92639,2856,3.0829348331
23111,0,名古屋市 港区,146745,149215,-2470,-1.655329558,45.64,3215.3,61713,59274,2439,4.1147889462
23112,0,名古屋市 南区,136935,141310,-4375,-3.096030005,18.46,7417.9,61064,61757,-693,-1.1221400003
23113,0,名古屋市 守山区,172845,168551,4294,2.5475968698,34.01,5082.2,69687,67087,2600,3.8755645654
23114,0,名古屋市 緑区,241822,229592,12230,5.3268406565,37.91,6378.8,95210,87672,7538,8.5979560179
23115,0,名古屋市 名東区,164080,161012,3068,1.9054480411,19.45,8436,73922,71894,2028,2.8208195399
23116,0,名古屋市 天白区,162683,158793,3890,2.4497301518,21.58,7538.6,74368,70574,3794,5.3759174767
23201,2,豊橋市,374765,376665,-1900,-0.5044270107,261.86,1431.2,144222,141424,2798,1.9784477882
23202,2,岡崎市,381051,372357,8694,2.3348560655,387.2,984.1,147418,138255,9163,6.6276084048
23203,2,一宮市,380868,378566,2302,0.6080841914,113.82,3346.2,142480,135837,6643,4.8904201359
23204,2,瀬戸市,129046,132224,-3178,-2.4034970958,111.4,1158.4,50327,50289,38,0.0755632444
23205,2,半田市,116908,118828,-1920,-1.6157807924,47.42,2465.4,46281,44869,1412,3.1469388665
23206,2,春日井市,306508,305569,939,0.3072955699,92.78,3303.6,124291,119187,5104,4.282346229
23207,2,豊川市,182436,181928,508,0.2792313443,161.14,1132.2,67976,64904,3072,4.7331443363
23208,2,津島市,63431,65258,-1827,-2.7996567471,25.09,2528.1,23833,23509,324,1.3781955847
23209,2,碧南市,71346,72018,-672,-0.9331000583,36.68,1945.1,26477,25265,1212,4.7971502078
23210,2,刈谷市,149765,145781,3984,2.7328664229,50.39,2972.1,62476,58917,3559,6.0407013256
23211,2,豊田市,422542,421487,1055,0.2503042798,918.32,460.1,169598,162065,7533,4.6481350076
23212,2,安城市,184140,178691,5449,3.049398123,86.05,2139.9,70862,66707,4155,6.2287316174
23213,2,西尾市,167990,165298,2692,1.6285738484,161.22,1042,58951,54435,4516,8.2961330027
23214,2,蒲郡市,81100,82249,-1149,-1.3969774709,56.95,1424.1,29950,28864,1086,3.7624722838
23215,2,犬山市,74308,75198,-890,-1.1835421155,74.9,992.1,28269,27359,910,3.3261449614
23216,2,常滑市,56547,54858,1689,3.0788581428,55.89,1011.8,22506,20769,1737,8.3634262603
23217,2,江南市,98359,99730,-1371,-1.3747117216,30.2,3256.9,37130,35768,1362,3.8078729591
23219,2,小牧市,149462,147132,2330,1.5836119947,62.81,2379.6,59383,55783,3600,6.4535790474
23220,2,稲沢市,136867,136358,509,0.3732820957,79.35,1724.9,49986,47500,2486,5.2336842105
23221,2,新城市,47133,49864,-2731,-5.4768971603,499.23,94.4,16454,16430,24,0.1460742544
23222,2,東海市,111944,107690,4254,3.9502275049,43.43,2577.6,46371,42859,3512,8.1943115798
23223,2,大府市,89157,85249,3908,4.5842179967,33.66,2648.8,35669,33484,2185,6.5255047187
23224,2,知多市,84617,84768,-151,-0.1781332578,45.9,1843.5,33009,31263,1746,5.5848766913
23225,2,知立市,70501,68398,2103,3.0746513056,16.31,4322.6,29312,27882,1430,5.1287569041
23226,2,尾張旭市,80787,81140,-353,-0.4350505299,21.03,3841.5,31806,31009,797,2.5702215486
23227,2,高浜市,46236,44027,2209,5.0173757013,13.11,3526.8,17684,16090,1594,9.906774394
23228,2,岩倉市,47562,47340,222,0.4689480355,10.47,4542.7,20390,18963,1427,7.5251806149
23229,2,豊明市,69127,69745,-618,-0.886085024,23.22,2977,27504,26872,632,2.3518904436
23230,2,日進市,87977,84237,3740,4.4398542208,34.91,2520.1,34210,33418,792,2.3699802502
23231,2,田原市,62364,64119,-1755,-2.737098208,191.12,326.3,21640,21145,495,2.3409789548
23232,2,愛西市,63088,64978,-1890,-2.9086767829,66.7,945.8,21131,20747,384,1.8508700053
23233,2,清須市,67327,65841,1486,2.2569523549,17.35,3880.5,27056,25381,1675,6.5994247666
23234,2,北名古屋市,84133,81571,2562,3.1408221059,18.37,4579.9,33742,31820,1922,6.0402262728
23235,2,弥富市,43269,43272,-3,-0.0069328896,49,883,16050,15041,1009,6.7083305631
23236,2,みよし市,61810,60098,1712,2.8486804885,32.19,1920.2,22552,21054,1498,7.1150375226
23237,2,あま市,86898,86714,184,0.2121918029,27.49,3161.1,33190,31355,1835,5.8523361505
23238,2,長久手市,57598,52022,5576,10.7185421552,21.55,2672.8,25069,22240,2829,12.720323741
23302,3,東郷町,42858,41851,1007,2.4061551695,18.03,2377,15766,14935,831,5.5641111483
23342,3,豊山町,15177,14405,772,5.3592502603,6.18,2455.8,6181,5776,405,7.0117728532
23361,3,大口町,23274,22446,828,3.6888532478,13.61,1710.1,8316,7723,593,7.6783633303
23362,3,扶桑町,33806,33558,248,0.7390190119,11.19,3021.1,12679,12161,518,4.2595181317
23424,3,大治町,30990,29891,1099,3.6766919809,6.59,4702.6,12105,11285,820,7.2662826761
23425,3,蟹江町,37085,36688,397,1.0820976886,11.09,3344,14971,14078,893,6.3432305725
23427,3,飛島村,4397,4525,-128,-2.8287292818,22.42,196.1,1259,1288,-29,-2.251552795
23441,3,阿久比町,27747,25466,2281,8.9570407602,23.8,1165.8,9627,8518,1109,13.0194881428
23442,3,東浦町,49230,49800,-570,-1.1445783133,31.14,1580.9,18524,18020,504,2.7968923418
23445,3,南知多町,18707,20549,-1842,-8.9639398511,38.37,487.5,6981,7197,-216,-3.0012505211
23446,3,美浜町,23575,25178,-1603,-6.3666693145,46.2,510.3,9314,9700,-386,-3.9793814433
23447,3,武豊町,42473,42408,65,0.1532729674,25.92,1638.6,16724,16192,532,3.2855731225
23501,3,幸田町,39549,37930,1619,4.2683891379,56.72,697.3,13693,12697,996,7.8443726865
23561,3,設楽町,5074,5769,-695,-12.0471485526,273.94,18.5,2015,2194,-179,-8.1586144029
23562,3,東栄町,3446,3757,-311,-8.2778812883,123.38,27.9,1436,1497,-61,-4.0748162993
23563,3,豊根村,1135,1336,-201,-15.0449101796,155.88,7.3,490,555,-65,-11.7117117117
24201,2,津市,279886,285746,-5860,-2.0507723643,711.11,393.6,114679,113092,1587,1.4032822835
24202,2,四日市市,311031,307766,3265,1.0608709214,206.44,1506.6,128309,120020,8289,6.9063489418
24203,2,伊勢市,127817,130271,-2454,-1.8837653814,208.35,613.5,50938,49361,1577,3.1948299265
24204,2,松阪市,163863,168017,-4154,-2.4723688674,623.66,262.7,63948,63611,337,0.5297825848
24205,2,桑名市,140303,140290,13,0.0092665194,136.68,1026.5,53741,51525,2216,4.3008248423
24207,2,鈴鹿市,196403,199293,-2890,-1.4501261961,194.46,1010,77725,75868,1857,2.4476722729
24208,2,名張市,78795,80284,-1489,-1.8546659359,129.77,607.2,30595,29481,1114,3.7787049286
24209,2,尾鷲市,18009,20033,-2024,-10.1033295063,192.71,93.5,8660,9219,-559,-6.0635643779
24210,2,亀山市,50254,51023,-769,-1.5071634361,191.04,263.1,19945,19213,732,3.8099203664
24211,2,鳥羽市,19448,21435,-1987,-9.269885701,107.34,181.2,7730,8057,-327,-4.058582599
24212,2,熊野市,17322,19662,-2340,-11.9011290815,373.35,46.4,8151,9008,-857,-9.5137655417
24214,2,いなべ市,45815,45684,131,0.2867524735,219.83,208.4,17106,15972,1134,7.0999248685
24215,2,志摩市,50341,54694,-4353,-7.9588254653,178.94,281.3,20057,20553,-496,-2.4132730015
24216,2,伊賀市,90581,97207,-6626,-6.8163815363,558.23,162.3,33651,34915,-1264,-3.6202205356
24303,3,木曽岬町,6357,6855,-498,-7.2647702407,15.74,403.9,2174,2250,-76,-3.3777777778
24324,3,東員町,25344,25661,-317,-1.235337672,22.68,1117.5,8863,8580,283,3.2983682984
24341,3,菰野町,40210,39978,232,0.5803191755,107.01,375.8,14423,13568,855,6.3015919811
24343,3,朝日町,10560,9626,934,9.7028880116,5.99,1762.9,3852,3389,463,13.6618471526
24344,3,川越町,14752,14003,749,5.348853817,8.73,1689.8,6023,5601,422,7.5343688627
24441,3,多気町,14878,15438,-560,-3.6274128773,103.06,144.4,5160,5278,-118,-2.2356953391
24442,3,明和町,22586,22833,-247,-1.081767617,41.04,550.3,7697,7422,275,3.7052007545
24443,3,大台町,9557,10416,-859,-8.2469278034,362.86,26.3,3778,3906,-128,-3.2770097286
24461,3,玉城町,15431,15297,134,0.875988756,40.91,377.2,5260,5064,196,3.8704581359
24470,3,度会町,8309,8692,-383,-4.4063506673,134.98,61.6,2626,2605,21,0.8061420345
24471,3,大紀町,8939,9846,-907,-9.2118626854,233.32,38.3,3691,3912,-221,-5.6492842536
24472,3,南伊勢町,12788,14791,-2003,-13.5420187952,241.89,52.9,5432,5926,-494,-8.3361457982
24543,3,紀北町,16338,18611,-2273,-12.213207243,256.53,63.7,7269,8088,-819,-10.1261127596
24561,3,御浜町,8741,9376,-635,-6.7726109215,88.13,99.2,3862,4000,-138,-3.45
24562,3,紀宝町,11207,11896,-689,-5.791862811,79.62,140.8,4947,5123,-176,-3.4354870193
25201,2,大津市,340973,337634,3339,0.9889406873,464.51,734,136153,130335,5818,4.463881536
25202,2,彦根市,113679,112156,1523,1.357930026,196.87,577.4,45546,43896,1650,3.7588846364
25203,2,長浜市,118193,124131,-5938,-4.7836559763,681.02,173.6,41788,43015,-1227,-2.8524933163
25204,2,近江八幡市,81312,81738,-426,-0.5211774205,177.45,458.2,29784,28617,1167,4.077995597
25206,2,草津市,137247,130874,6373,4.869569204,67.82,2023.7,60224,57318,2906,5.0699605709
25207,2,守山市,79859,76560,3299,4.3090386625,55.74,1432.7,29052,26819,2233,8.3261866587
25208,2,栗東市,66749,63655,3094,4.8605765454,52.69,1266.8,24592,22614,1978,8.7467940214
25209,2,甲賀市,90901,92704,-1803,-1.9448998964,481.62,188.7,32366,31074,1292,4.1578168244
25210,2,野洲市,49889,49955,-66,-0.132118907,80.14,622.5,18143,17476,667,3.8166628519
25211,2,湖南市,54289,54614,-325,-0.5950855092,70.4,771.2,21286,20463,823,4.021893173
25212,2,高島市,50025,52486,-2461,-4.6888694128,693.05,72.2,18149,18132,17,0.0937568939
25213,2,東近江市,114180,115479,-1299,-1.1248798483,388.37,294,40691,38941,1750,4.4939780694
25214,2,米原市,38719,40060,-1341,-3.3474787818,250.39,154.6,13236,12952,284,2.1927115503
25383,3,日野町,21873,22870,-997,-4.3594228247,117.6,186,7728,7678,50,0.6512112529
25384,3,竜王町,12434,12916,-482,-3.7318055125,44.55,279.1,4266,4413,-147,-3.3310673012
25425,3,愛荘町,20778,20118,660,3.2806441992,37.97,547.2,7209,6761,448,6.6262387221
25441,3,豊郷町,7422,7566,-144,-1.9032513878,7.8,951.5,2606,2541,65,2.5580480126
25442,3,甲良町,7039,7500,-461,-6.1466666667,13.63,516.4,2310,2320,-10,-0.4310344828
25443,3,多賀町,7355,7761,-406,-5.2312846283,135.77,54.2,2421,2383,38,1.5946286194
26100,1,京都市,1475183,1474015,1168,0.0792393565,827.83,1782,705874,681581,24293,3.5642132043
26101,0,京都市 北区,119474,122037,-2563,-2.1001827315,94.88,1259.2,56804,56406,398,0.7055986952
26102,0,京都市 上京区,85113,83264,1849,2.2206475788,7.03,12107.1,46849,43389,3460,7.9743713845
26103,0,京都市 左京区,168266,168802,-536,-0.3175317828,246.77,681.9,83423,82067,1356,1.6523084797
26104,0,京都市 中京区,109341,105306,4035,3.831690502,7.41,14755.9,59085,55772,3313,5.9402567597
26105,0,京都市 東山区,39044,40528,-1484,-3.6616660087,7.48,5219.8,21381,21114,267,1.2645637965
26106,0,京都市 下京区,82668,79287,3381,4.2642551742,6.78,12192.9,47206,43651,3555,8.1441433186
26107,0,京都市 南区,99927,98744,1183,1.1980474763,15.81,6320.5,47094,45036,2058,4.5696775913
26108,0,京都市 右京区,204262,202943,1319,0.649936189,292.07,699.4,94525,90808,3717,4.0932516959
26109,0,京都市 伏見区,280655,284085,-3430,-1.2073851136,61.66,4551.7,125947,123597,2350,1.9013406474
26110,0,京都市 山科区,135471,136045,-574,-0.4219192179,28.7,4720.2,60451,58321,2130,3.652200751
26111,0,京都市 西京区,150962,152974,-2012,-1.3152561873,59.24,2548.3,63109,61420,1689,2.7499185933
26201,2,福知山市,78935,79652,-717,-0.9001657209,552.54,142.9,32170,30890,1280,4.1437358368
26202,2,舞鶴市,83990,88669,-4679,-5.2769288026,342.12,245.5,34709,35504,-795,-2.2391843173
26203,2,綾部市,33821,35836,-2015,-5.6228373702,347.1,97.4,13766,14006,-240,-1.7135513351
26204,2,宇治市,184678,189609,-4931,-2.6006149497,67.54,2734.4,73317,72907,410,0.5623602672
26205,2,宮津市,18426,19948,-1522,-7.6298375777,172.74,106.7,7738,8180,-442,-5.4034229829
26206,2,亀岡市,89479,92399,-2920,-3.1602073616,224.8,398,33915,33625,290,0.8624535316
26207,2,城陽市,76869,80037,-3168,-3.9581693467,32.71,2350,29884,29972,-88,-0.2936073669
26208,2,向日市,53380,54328,-948,-1.7449565602,7.72,6914.5,21356,21282,74,0.3477116812
26209,2,長岡京市,80090,79844,246,0.3081007966,19.17,4177.9,32491,31514,977,3.1002094307
26210,2,八幡市,72664,74227,-1563,-2.1057027766,24.35,2984.1,29259,28795,464,1.6113908665
26211,2,京田辺市,70835,67910,2925,4.3071712561,42.92,1650.4,29693,27839,1854,6.6597219728
26212,2,京丹後市,55054,59038,-3984,-6.7481960771,501.43,109.8,20469,20690,-221,-1.0681488642
26213,2,南丹市,33145,35214,-2069,-5.8755040609,616.4,53.8,12783,12721,62,0.4873830674
26214,2,木津川市,72840,69761,3079,4.4136408595,85.13,855.6,26656,24393,2263,9.2772516706
26303,3,大山崎町,15181,15121,60,0.3967991535,5.97,2542.9,5993,5750,243,4.2260869565
26322,3,久御山町,15805,15914,-109,-0.6849315068,13.86,1140.3,6216,5870,346,5.8943781942
26343,3,井手町,7910,8447,-537,-6.3572866106,18.04,438.5,3059,3110,-51,-1.6398713826
26344,3,宇治田原町,9319,9711,-392,-4.0366594583,58.16,160.2,3232,3097,135,4.3590571521
26364,3,笠置町,1368,1626,-258,-15.8671586716,23.52,58.2,573,631,-58,-9.1917591125
26365,3,和束町,3956,4482,-526,-11.7358322178,64.93,60.9,1445,1509,-64,-4.2412193506
26366,3,精華町,36376,35630,746,2.0937412293,25.68,1416.5,12775,12117,658,5.4303870595
26367,3,南山城村,2652,3078,-426,-13.8401559454,64.11,41.4,1068,1128,-60,-5.3191489362
26407,3,京丹波町,14453,15732,-1279,-8.1299262649,303.09,47.7,5448,5660,-212,-3.7455830389
26463,3,伊根町,2110,2410,-300,-12.4481327801,61.95,34.1,873,939,-66,-7.0287539936
26465,3,与謝野町,21834,23454,-1620,-6.9071373753,108.38,201.5,8140,8347,-207,-2.47993291
27100,1,大阪市,2691185,2665314,25871,0.9706548647,225.21,11949.7,1354793,1317990,36803,2.7923580604
27102,0,大阪市 都島区,104727,102632,2095,2.0412736768,6.08,17224.8,51549,50075,1474,2.9435846231
27103,0,大阪市 福島区,72484,67290,5194,7.7188289493,4.67,15521.2,37510,34379,3131,9.1073038774
27104,0,大阪市 此花区,66656,65569,1087,1.6577956046,19.25,3462.6,30712,29495,1217,4.1261230717
27106,0,大阪市 西区,92430,83058,9372,11.283681283,5.21,17740.9,52138,47073,5065,10.7598835851
27107,0,大阪市 港区,82035,84947,-2912,-3.4280198241,7.86,10437,40348,40713,-365,-0.8965195392
27108,0,大阪市 大正区,65141,69510,-4369,-6.2854265573,9.43,6907.8,29209,30521,-1312,-4.2986795977
27109,0,大阪市 天王寺区,75729,69775,5954,8.5331422429,4.84,15646.5,38058,34730,3328,9.5824935215
27111,0,大阪市 浪速区,69766,61745,8021,12.9905255486,4.39,15892,47541,42392,5149,12.1461596528
27113,0,大阪市 西淀川区,95490,97504,-2014,-2.0655562849,14.22,6715.2,42924,43608,-684,-1.5685195377
27114,0,大阪市 東淀川区,175530,176585,-1055,-0.5974459892,13.27,13227.6,92536,91894,642,0.6986310314
27115,0,大阪市 東成区,80563,80231,332,0.4138051377,4.54,17745.2,39683,38920,763,1.9604316547
27116,0,大阪市 生野区,130167,134009,-3842,-2.8669716213,8.37,15551.6,63622,62808,814,1.2960132467
27117,0,大阪市 旭区,91608,92455,-847,-0.9161213563,6.32,14494.9,43700,43842,-142,-0.3238903335
27118,0,大阪市 城東区,164697,165832,-1135,-0.6844276135,8.38,19653.6,76455,76043,412,0.5417987191
27119,0,大阪市 阿倍野区,107626,106350,1276,1.1998119417,5.98,17997.7,50104,49318,786,1.5937385944
27120,0,大阪市 住吉区,154239,155572,-1333,-0.8568379914,9.4,16408.4,71718,73917,-2199,-2.9749583993
27121,0,大阪市 東住吉区,126299,130724,-4425,-3.3849943392,9.75,12953.7,57797,60057,-2260,-3.7630917295
27122,0,大阪市 西成区,111883,121972,-10089,-8.2715705244,7.37,15180.9,69225,74466,-5241,-7.0381113528
27123,0,大阪市 淀川区,176201,172078,4123,2.3960064622,12.64,13940,94460,91116,3344,3.6700469731
27124,0,大阪市 鶴見区,111557,111182,375,0.3372848123,8.17,13654.5,46358,45264,1094,2.416931778
27125,0,大阪市 住之江区,122988,127210,-4222,-3.3189214684,20.61,5967.4,56920,56593,327,0.5778099765
27126,0,大阪市 平野区,196633,200005,-3372,-1.6859578511,15.28,12868.7,88960,86500,2460,2.8439306358
27127,0,大阪市 北区,123667,110392,13275,12.0253279223,10.34,11960.1,74182,65204,8978,13.7690939206
27128,0,大阪市 中央区,93069,78687,14382,18.2774791262,8.87,10492.6,59084,49062,10022,20.4272145449
27140,1,堺市,839310,841966,-2656,-0.3154521679,149.82,5602.1,350301,344465,5836,1.6942214739
27141,0,堺市 堺区,148205,148748,-543,-0.365046925,23.65,6266.6,69116,67426,1690,2.5064515172
27142,0,堺市 中区,124543,123532,1011,0.8184114238,17.88,6965.5,48538,47203,1335,2.8282100714
27143,0,堺市 東区,85189,85444,-255,-0.2984410842,10.49,8121,34722,34404,318,0.9243111266
27144,0,堺市 西区,135746,133622,2124,1.5895586056,28.62,4743,54614,53442,1172,2.1930316979
27145,0,堺市 南区,147626,154779,-7153,-4.6214279715,40.39,3655,60427,61008,-581,-0.9523341201
27146,0,堺市 北区,158845,156561,2284,1.4588562924,15.6,10182.4,68538,67116,1422,2.1187198284
27147,0,堺市 美原区,39156,39280,-124,-0.3156822811,13.2,2966.4,14346,13866,480,3.4617048897
27202,2,岸和田市,194911,199234,-4323,-2.1698103737,72.68,2681.8,75247,75353,-106,-0.1406712407
27203,2,豊中市,395479,389341,6138,1.5765100516,36.39,10867.8,170325,166677,3648,2.1886643028
27204,2,池田市,103069,104229,-1160,-1.1129340203,22.14,4655.3,45777,45661,116,0.2540461225
27205,2,吹田市,374468,355798,18670,5.2473594568,36.09,10375.9,168473,154702,13771,8.901630231
27206,2,泉大津市,75897,77548,-1651,-2.1290039717,14.31,5303.8,31090,30962,128,0.4134099864
27207,2,高槻市,351829,357359,-5530,-1.5474634751,105.29,3341.5,148048,145426,2622,1.8029788346
27208,2,貝塚市,88694,90492,-1798,-1.9869159705,43.93,2019,33355,32986,369,1.1186563997
27209,2,守口市,143042,146697,-3655,-2.4915301608,12.71,11254.3,64832,65129,-297,-0.4560180565
27210,2,枚方市,404152,407978,-3826,-0.9377956655,65.12,6206.3,167418,163983,3435,2.0947293317
27211,2,茨木市,280033,274822,5211,1.8961364083,76.49,3661,116683,112282,4401,3.9195953047
27212,2,八尾市,268800,271460,-2660,-0.9798865395,41.72,6443,110414,108704,1710,1.5730791875
27213,2,泉佐野市,100966,100801,165,0.1636888523,56.51,1786.7,41566,39084,2482,6.3504247262
27214,2,富田林市,113984,119576,-5592,-4.6765237171,39.72,2869.7,45613,45600,13,0.0285087719
27215,2,寝屋川市,237518,238204,-686,-0.2879884469,24.7,9616.1,101549,99178,2371,2.3906511525
27216,2,河内長野市,106987,112490,-5503,-4.8919903991,109.63,975.9,42144,41339,805,1.9473136747
27217,2,松原市,120750,124594,-3844,-3.0852207971,16.66,7247.9,49958,49218,740,1.5035149742
27218,2,大東市,123217,127534,-4317,-3.3849796917,18.27,6744.2,51949,52381,-432,-0.824726523
27219,2,和泉市,186109,184988,1121,0.6059852531,84.98,2190,71013,68342,2671,3.9082848029
27220,2,箕面市,133411,129895,3516,2.7068016475,47.9,2785.2,56829,53560,3269,6.1034353996
27221,2,柏原市,71112,74773,-3661,-4.8961523545,25.33,2807.4,29009,29685,-676,-2.2772443995
27222,2,羽曳野市,112683,117681,-4998,-4.2470747189,26.45,4260.2,44126,44693,-567,-1.2686550467
27223,2,門真市,123576,130282,-6706,-5.1472958659,12.3,10046.8,55825,57880,-2055,-3.5504492053
27224,2,摂津市,85007,83720,1287,1.5372670807,14.87,5716.7,36873,34987,1886,5.3905736416
27225,2,高石市,56529,59572,-3043,-5.1081044786,11.3,5002.6,22461,23012,-551,-2.3944029202
27226,2,藤井寺市,65438,66165,-727,-1.0987682309,8.89,7360.9,27133,26754,379,1.4166106003
27227,2,東大阪市,502784,509533,-6749,-1.3245462021,61.78,8138.3,223485,217762,5723,2.6280985663
27228,2,泉南市,62438,64403,-1965,-3.051100104,48.98,1274.8,22800,22604,196,0.8671031676
27229,2,四條畷市,56075,57554,-1479,-2.5697605727,18.69,3000.3,22089,21726,363,1.6708091687
27230,2,交野市,76435,77686,-1251,-1.6103287594,25.55,2991.6,28923,28488,435,1.5269587195
27231,2,大阪狭山市,57792,58227,-435,-0.7470760987,11.92,4848.3,22982,22473,509,2.2649401504
27232,2,阪南市,54276,56646,-2370,-4.1838788264,36.17,1500.6,20710,20500,210,1.0243902439
27301,3,島本町,29983,28935,1048,3.6219111802,16.81,1783.6,12012,11248,764,6.7923186344
27321,3,豊能町,19934,21989,-2055,-9.3455818819,34.34,580.5,7760,7871,-111,-1.410240122
27322,3,能勢町,10256,11650,-1394,-11.9656652361,98.75,103.9,3717,3853,-136,-3.5297171036
27341,3,忠岡町,17298,18149,-851,-4.6889635793,3.97,4357.2,6726,6744,-18,-0.2669039146
27361,3,熊取町,44435,45096,-661,-1.4657619301,17.24,2577.4,16483,15775,708,4.4881141046
27362,3,田尻町,8417,8085,332,4.1063698207,5.62,1497.7,3772,3255,517,15.8832565284
27366,3,岬町,15938,17504,-1566,-8.9465265082,49.18,324.1,6407,6659,-252,-3.7843520048
27381,3,太子町,13748,14220,-472,-3.3192686357,14.17,970.2,5066,4881,185,3.7902069248
27382,3,河南町,16126,17040,-914,-5.3638497653,25.26,638.4,6115,6426,-311,-4.8397136632
27383,3,千早赤阪村,5378,6015,-637,-10.5901911887,37.3,144.2,2036,2088,-52,-2.4904214559
28100,1,神戸市,1537272,1544200,-6928,-0.4486465484,557.02,2759.8,705459,684183,21276,3.1096943362
28101,0,神戸市 東灘区,213634,210408,3226,1.533211665,34.02,6279.7,97265,94039,3226,3.4304916045
28102,0,神戸市 灘区,136088,133451,2637,1.9760061746,32.66,4166.8,67407,65178,2229,3.4198655988
28105,0,神戸市 兵庫区,106956,108304,-1348,-1.2446447038,14.68,7285.8,57875,56954,921,1.6170944973
28106,0,神戸市 長田区,97912,101624,-3712,-3.6526804692,11.36,8619,48780,48224,556,1.1529528865
28107,0,神戸市 須磨区,162468,167475,-5007,-2.9896999552,28.93,5615.9,73278,71657,1621,2.2621655944
28108,0,神戸市 垂水区,219474,220411,-937,-0.425114899,28.11,7807.7,95473,94016,1457,1.5497362151
28109,0,神戸市 北区,219805,226836,-7031,-3.099596184,240.29,914.7,87126,86350,776,0.8986682108
28110,0,神戸市 中央区,135153,126393,8760,6.9307635708,28.97,4665.3,81022,73814,7208,9.7650852142
28111,0,神戸市 西区,245782,249298,-3516,-1.4103602917,138.01,1780.9,97233,93951,3282,3.4933103426
28201,2,姫路市,535664,536270,-606,-0.1130027785,534.47,1002.2,212801,205587,7214,3.5089767349
28202,2,尼崎市,452563,453748,-1185,-0.2611581759,50.72,8922.8,210433,209343,1090,0.520676593
28203,2,明石市,293409,290959,2450,0.842043037,49.42,5937,121890,116948,4942,4.2258097616
28204,2,西宮市,487850,482640,5210,1.0794795293,99.96,4880.5,210965,202648,8317,4.1041609096
28205,2,洲本市,44258,47254,-2996,-6.3402040039,182.38,242.7,18081,18447,-366,-1.9840624492
28206,2,芦屋市,95350,93238,2112,2.2651708531,18.47,5162.4,41881,39753,2128,5.3530551153
28207,2,伊丹市,196883,196127,756,0.3854645204,25,7875.3,78903,77263,1640,2.1226201416
28208,2,相生市,30129,31158,-1029,-3.3025226266,90.4,333.3,12153,12141,12,0.0988386459
28209,2,豊岡市,82250,85592,-3342,-3.9045705206,697.55,117.9,30189,29741,448,1.5063380518
28210,2,加古川市,267435,266937,498,0.1865608739,138.48,1931.2,103495,99645,3850,3.8637161925
28212,2,赤穂市,48567,50523,-1956,-3.8715040675,126.86,382.8,18729,18826,-97,-0.5152448741
28213,2,西脇市,40866,42802,-1936,-4.5231531237,132.44,308.6,15049,14989,60,0.4002935486
28214,2,宝塚市,224903,225700,-797,-0.3531236154,101.8,2209.3,94140,91737,2403,2.619444717
28215,2,三木市,77178,81009,-3831,-4.7291041736,176.51,437.2,28653,28506,147,0.5156809093
28216,2,高砂市,91030,93901,-2871,-3.0574754262,34.38,2647.8,36340,35737,603,1.6873268601
28217,2,川西市,156375,156423,-48,-0.0306860244,53.44,2926.2,62675,60584,2091,3.4514063119
28218,2,小野市,48580,49680,-1100,-2.2141706924,92.94,522.7,16860,16470,390,2.3679417122
28219,2,三田市,112691,114216,-1525,-1.3351894656,210.32,535.8,41070,40068,1002,2.5007487272
28220,2,加西市,44313,47993,-3680,-7.6677848853,150.98,293.5,15364,15188,176,1.1588095865
28221,2,篠山市,41490,43263,-1773,-4.0981901394,377.59,109.9,15578,15342,236,1.5382609829
28222,2,養父市,24288,26501,-2213,-8.3506282782,422.91,57.4,8713,9062,-349,-3.8512469653
28223,2,丹波市,64660,67757,-3097,-4.570745458,493.21,131.1,22553,22461,92,0.4095988602
28224,2,南あわじ市,46912,49834,-2922,-5.8634667095,229.01,204.8,16968,16981,-13,-0.076556151
28225,2,朝来市,30805,32814,-2009,-6.1223867861,403.06,76.4,11500,11655,-155,-1.3299013299
28226,2,淡路市,43977,46459,-2482,-5.3423448632,184.35,238.6,17451,17436,15,0.0860289057
28227,2,宍粟市,37773,40938,-3165,-7.731203283,658.54,57.4,12723,13174,-451,-3.4234097465
28228,2,加東市,40310,40181,129,0.3210472611,157.55,255.9,15086,14133,953,6.7430835633
28229,2,たつの市,77419,80518,-3099,-3.8488288333,210.87,367.1,27297,26803,494,1.8430772675
28301,3,猪名川町,30838,31739,-901,-2.8387787895,90.33,341.4,10780,10547,233,2.2091590026
28365,3,多可町,21200,23104,-1904,-8.2409972299,185.19,114.5,6665,6709,-44,-0.6558354449
28381,3,稲美町,31020,31026,-6,-0.0193386192,34.92,888.3,11026,10226,800,7.8231957755
28382,3,播磨町,33739,33183,556,1.675556761,9.13,3695.4,13258,12581,677,5.3811302758
28442,3,市川町,12300,13288,-988,-7.4352799518,82.67,148.8,4334,4350,-16,-0.367816092
28443,3,福崎町,19738,19830,-92,-0.4639435199,45.79,431.1,6906,6639,267,4.0216900136
28446,3,神河町,11452,12289,-837,-6.8109691594,202.23,56.6,3798,3813,-15,-0.3933910307
28464,3,太子町,33690,33438,252,0.7536335905,22.61,1490,12092,11640,452,3.883161512
28481,3,上郡町,15224,16636,-1412,-8.4876172157,150.26,101.3,5715,5870,-155,-2.6405451448
28501,3,佐用町,17510,19265,-1755,-9.1097845834,307.44,57,6108,6301,-193,-3.0630058721
28585,3,香美町,18070,19696,-1626,-8.2554833469,368.77,49,6228,6449,-221,-3.4268878896
28586,3,新温泉町,14819,16004,-1185,-7.4043989003,241.01,61.5,5291,5342,-51,-0.9546986148
29201,2,奈良市,360310,366591,-6281,-1.7133535739,276.94,1301,148920,147421,1499,1.0168157861
29202,2,大和高田市,64817,68451,-3634,-5.3089071014,16.48,3933.1,25619,25815,-196,-0.7592484989
29203,2,大和郡山市,87050,89023,-1973,-2.2162811858,42.69,2039.1,34138,33235,903,2.7170151948
29204,2,天理市,67398,69178,-1780,-2.573072364,86.42,779.9,25810,25396,414,1.6301779808
29205,2,橿原市,124111,125605,-1494,-1.1894430954,39.56,3137.3,49923,48740,1183,2.4271645466
29206,2,桜井市,57244,60146,-2902,-4.8249260134,98.91,578.7,21672,21417,255,1.1906429472
29207,2,五條市,30997,34460,-3463,-10.0493325595,292.02,106.1,11199,11738,-539,-4.5919236667
29208,2,御所市,26868,30287,-3419,-11.2886717073,60.58,443.5,10415,10603,-188,-1.7730830897
29209,2,生駒市,118233,118113,120,0.1015976226,53.15,2224.5,45593,44484,1109,2.4930312022
29210,2,香芝市,77561,75227,2334,3.1026094354,24.26,3197.1,27802,26131,1671,6.3947036087
29211,2,葛城市,36635,35859,776,2.164031345,33.72,1086.4,12544,11891,653,5.4915482298
29212,2,宇陀市,31105,34227,-3122,-9.121453823,247.5,125.7,11155,11527,-372,-3.227205691
29322,3,山添村,3674,4107,-433,-10.5429754078,66.52,55.2,1144,1196,-52,-4.347826087
29342,3,平群町,18883,19727,-844,-4.2784001622,23.9,790.1,7158,7090,68,0.9590973202
29343,3,三郷町,23571,23440,131,0.5588737201,8.79,2681.6,9155,8978,177,1.9714858543
29344,3,斑鳩町,27303,27734,-431,-1.5540491815,14.27,1913.3,10330,10184,146,1.4336213668
29345,3,安堵町,7443,7929,-486,-6.1293984109,4.31,1726.9,2875,2934,-59,-2.0109066121
29361,3,川西町,8485,8653,-168,-1.9415231712,5.93,1430.9,3248,3152,96,3.0456852792
29362,3,三宅町,6836,7440,-604,-8.1182795699,4.06,1683.7,2629,2637,-8,-0.3033750474
29363,3,田原本町,31691,32121,-430,-1.3386880857,21.09,1502.7,11463,10954,509,4.6467044002
29385,3,曽爾村,1549,1895,-346,-18.2585751979,47.76,32.4,622,675,-53,-7.8518518519
29386,3,御杖村,1759,2102,-343,-16.3177925785,79.58,22.1,748,813,-65,-7.9950799508
29401,3,高取町,7195,7657,-462,-6.0336946585,25.79,279,2396,2435,-39,-1.6016427105
29402,3,明日香村,5523,5856,-333,-5.6864754098,24.1,229.2,1779,1799,-20,-1.1117287382
29424,3,上牧町,22054,23728,-1674,-7.0549561699,6.14,3591.9,8085,8368,-283,-3.3819311663
29425,3,王寺町,23025,22182,843,3.8003786854,7.01,3284.6,9347,8718,629,7.2149575591
29426,3,広陵町,33487,33070,417,1.2609615966,16.3,2054.4,11012,10525,487,4.6270783848
29427,3,河合町,17941,18531,-590,-3.1838540823,8.23,2180,6712,6663,49,0.7354044725
29441,3,吉野町,7399,8642,-1243,-14.3832446193,95.65,77.4,2946,3172,-226,-7.1248423707
29442,3,大淀町,18069,19176,-1107,-5.7728410513,38.1,474.3,6509,6609,-100,-1.513088213
29443,3,下市町,5664,7020,-1356,-19.3162393162,61.99,91.4,2232,2434,-202,-8.299096138
29444,3,黒滝村,660,840,-180,-21.4285714286,47.7,13.8,311,357,-46,-12.8851540616
29446,3,天川村,1354,1572,-218,-13.8676844784,175.66,7.7,628,711,-83,-11.6736990155
29447,3,野迫川村,449,524,-75,-14.3129770992,154.9,2.9,227,249,-22,-8.8353413655
29449,3,十津川村,3508,4107,-599,-14.5848551254,672.38,5.2,1578,1831,-253,-13.8175860186
29450,3,下北山村,895,1039,-144,-13.8594802695,133.39,6.7,517,559,-42,-7.5134168157
29451,3,上北山村,512,683,-171,-25.0366032211,274.22,1.9,270,361,-91,-25.2077562327
29452,3,川上村,1313,1643,-330,-20.0852099817,269.26,4.9,680,786,-106,-13.4860050891
29453,3,東吉野村,1745,2143,-398,-18.5720951937,131.65,13.3,830,935,-105,-11.2299465241
30201,2,和歌山市,364154,370364,-6210,-1.6767288397,208.84,1743.7,153089,152569,520,0.3408293952
30202,2,海南市,51860,54783,-2923,-5.3355968092,101.06,513.2,20678,20750,-72,-0.3469879518
30203,2,橋本市,63621,66361,-2740,-4.1289311493,130.55,487.3,23653,23468,185,0.7883074825
30204,2,有田市,28470,30592,-2122,-6.9364539749,36.89,771.8,10576,10735,-159,-1.4811364695
30205,2,御坊市,24801,26111,-1310,-5.0170426257,43.91,564.8,9913,9993,-80,-0.8005603923
30206,2,田辺市,74770,79119,-4349,-5.4967833264,1026.91,72.8,32163,32693,-530,-1.6211421405
30207,2,新宮市,29331,31498,-2167,-6.8798018922,255.23,114.9,13617,14063,-446,-3.1714427931
30208,2,紀の川市,62616,65840,-3224,-4.8967193196,228.21,274.4,23457,23226,231,0.9945750452
30209,2,岩出市,53452,52882,570,1.0778714875,38.51,1388,20774,19545,1229,6.2880532105
30304,3,紀美野町,9206,10391,-1185,-11.4040997017,128.34,71.7,3762,3971,-209,-5.2631578947
30341,3,かつらぎ町,16992,18230,-1238,-6.7910038398,151.69,112,6315,6463,-148,-2.2899582237
30343,3,九度山町,4377,4963,-586,-11.8073745718,44.15,99.1,1649,1741,-92,-5.2843193567
30344,3,高野町,3352,3975,-623,-15.6729559748,137.03,24.5,1468,1788,-320,-17.8970917226
30361,3,湯浅町,12200,13210,-1010,-7.6457229372,20.79,586.8,4755,4971,-216,-4.3452021726
30362,3,広川町,7224,7714,-490,-6.3520871143,65.33,110.6,2503,2496,7,0.2804487179
30366,3,有田川町,26361,27162,-801,-2.9489728297,351.84,74.9,9426,9225,201,2.1788617886
30381,3,美浜町,7480,8077,-597,-7.3913581775,12.77,585.7,2964,3086,-122,-3.9533376539
30382,3,日高町,7641,7432,209,2.8121636168,46.19,165.4,2782,2648,134,5.0604229607
30383,3,由良町,5837,6508,-671,-10.3103872157,30.94,188.7,2223,2419,-196,-8.1025217032
30390,3,印南町,8068,8606,-538,-6.251452475,113.62,71,2918,3015,-97,-3.2172470978
30391,3,みなべ町,12742,13470,-728,-5.4046028211,120.28,105.9,4421,4395,26,0.5915813424
30392,3,日高川町,9776,10509,-733,-6.974973832,331.59,29.5,3650,3750,-100,-2.6666666667
30401,3,白浜町,21533,22696,-1163,-5.1242509693,200.96,107.2,9538,9616,-78,-0.8111480865
30404,3,上富田町,14989,14807,182,1.2291483758,57.37,261.3,6017,5610,407,7.2549019608
30406,3,すさみ町,4127,4730,-603,-12.7484143763,174.46,23.7,1927,2114,-187,-8.8457899716
30421,3,那智勝浦町,15682,17080,-1398,-8.1850117096,183.31,85.5,7296,7723,-427,-5.5289395313
30422,3,太地町,3087,3250,-163,-5.0153846154,5.81,531.3,1384,1417,-33,-2.3288637968
30424,3,古座川町,2826,3103,-277,-8.9268449887,294.23,9.6,1378,1484,-106,-7.1428571429
30427,3,北山村,446,486,-40,-8.2304526749,48.2,9.3,239,256,-17,-6.640625
30428,3,串本町,16558,18249,-1691,-9.266261165,135.67,122,7797,8323,-526,-6.3198365974
31201,2,鳥取市,193717,197449,-3732,-1.8901083318,765.31,253.1,75941,73288,2653,3.6199650693
31202,2,米子市,149313,148271,1042,0.7027672303,132.42,1127.6,60037,57610,2427,4.212810276
31203,2,倉吉市,49044,50720,-1676,-3.3044164038,272.06,180.3,18548,18266,282,1.5438519654
31204,2,境港市,34174,35259,-1085,-3.077228509,29.02,1177.6,13094,12870,224,1.7404817405
31302,3,岩美町,11485,12362,-877,-7.0943213072,122.32,93.9,3993,3982,11,0.2762430939
31325,3,若桜町,3269,3873,-604,-15.5951458817,199.18,16.4,1271,1405,-134,-9.537366548
31328,3,智頭町,7154,7718,-564,-7.3075926406,224.7,31.8,2487,2569,-82,-3.1919034644
31329,3,八頭町,16985,18427,-1442,-7.82547349,206.71,82.2,5359,5454,-95,-1.7418408508
31364,3,三朝町,6490,7015,-525,-7.4839629366,233.52,27.8,2290,2385,-95,-3.9832285115
31370,3,湯梨浜町,16550,17029,-479,-2.8128486699,77.94,212.3,5482,5418,64,1.1812476929
31371,3,琴浦町,17416,18531,-1115,-6.0169445794,139.97,124.4,5795,5834,-39,-0.6684950291
31372,3,北栄町,14820,15442,-622,-4.0279756508,56.94,260.3,4813,4810,3,0.0623700624
31384,3,日吉津村,3439,3339,100,2.9949086553,4.2,818.8,1144,1070,74,6.9158878505
31386,3,大山町,16470,17491,-1021,-5.837287748,189.83,86.8,5300,5338,-38,-0.7118771075
31389,3,南部町,10950,11536,-586,-5.0797503467,114.03,96,3514,3511,3,0.085445742
31390,3,伯耆町,11118,11621,-503,-4.3283710524,139.44,79.7,3604,3610,-6,-0.1662049861
31401,3,日南町,4765,5460,-695,-12.7289377289,340.96,14,1933,2099,-166,-7.9085278704
31402,3,日野町,3278,3745,-467,-12.4699599466,133.98,24.5,1279,1371,-92,-6.7104303428
31403,3,江府町,3004,3379,-375,-11.0979579757,124.52,24.1,1010,1074,-64,-5.9590316574
32201,2,松江市,206230,208613,-2383,-1.1423065677,572.99,359.9,83031,81166,1865,2.2977601459
32202,2,浜田市,58105,61713,-3608,-5.8464180967,690.66,84.1,24498,24972,-474,-1.898125901
32203,2,出雲市,171938,171485,453,0.2641630463,624.36,275.4,60130,55952,4178,7.4671146697
32204,2,益田市,47718,50015,-2297,-4.5926222133,733.19,65.1,19037,19243,-206,-1.0705191498
32205,2,大田市,35166,37996,-2830,-7.4481524371,435.71,80.7,13613,14312,-699,-4.8840134153
32206,2,安来市,39528,41836,-2308,-5.5167798069,420.93,93.9,12805,12820,-15,-0.1170046802
32207,2,江津市,24468,25697,-1229,-4.7826594544,268.24,91.2,10123,10320,-197,-1.9089147287
32209,2,雲南市,39032,41917,-2885,-6.8826490445,553.18,70.6,12527,12905,-378,-2.9290972491
32343,3,奥出雲町,13063,14456,-1393,-9.6361372441,368.01,35.5,4464,4713,-249,-5.2832590707
32386,3,飯南町,5031,5534,-503,-9.0892663535,242.88,20.7,1842,1944,-102,-5.2469135802
32441,3,川本町,3442,3900,-458,-11.7435897436,106.43,32.3,1457,1666,-209,-12.5450180072
32448,3,美郷町,4900,5351,-451,-8.4283311531,282.92,17.3,2010,2157,-147,-6.8150208623
32449,3,邑南町,11101,11959,-858,-7.1745129191,419.29,26.5,4224,4510,-286,-6.3414634146
32501,3,津和野町,7653,8427,-774,-9.1847632609,307.03,24.9,3300,3411,-111,-3.2541776605
32505,3,吉賀町,6374,6810,-436,-6.402349486,336.5,18.9,2810,2805,5,0.1782531194
32525,3,海士町,2353,2374,-21,-0.8845829823,33.43,70.4,1057,1052,5,0.4752851711
32526,3,西ノ島町,3027,3136,-109,-3.4757653061,55.96,54.1,1499,1477,22,1.4895057549
32527,3,知夫村,615,657,-42,-6.3926940639,13.7,44.9,331,326,5,1.5337423313
32528,3,隠岐の島町,14608,15521,-913,-5.8823529412,242.83,60.2,6250,6468,-218,-3.3704390847
33100,1,岡山市,719474,709584,9890,1.3937743805,789.96,910.8,309409,296790,12619,4.2518278918
33101,0,岡山市 北区,309484,302685,6799,2.2462295786,450.7,686.7,146147,139204,6943,4.9876440332
33102,0,岡山市 中区,146232,142237,3995,2.8086925343,51.25,2853.3,61528,58961,2567,4.3537253439
33103,0,岡山市 東区,95577,96948,-1371,-1.4141601683,160.53,595.4,36198,35199,999,2.838148811
33104,0,岡山市 南区,168181,167714,467,0.2784502188,127.48,1319.3,65536,63426,2110,3.3267114433
33202,2,倉敷市,477118,475513,1605,0.3375302042,355.63,1341.6,189847,183303,6544,3.5700452257
33203,2,津山市,103746,106788,-3042,-2.8486346781,506.33,204.9,40303,39876,427,1.0708195406
33204,2,玉野市,60736,64588,-3852,-5.9639561528,103.58,586.4,24764,25449,-685,-2.6916578255
33205,2,笠岡市,50568,54225,-3657,-6.7441217151,136.39,370.8,19189,19676,-487,-2.4750965643
33207,2,井原市,41390,43927,-2537,-5.7754911558,243.54,170,14914,15108,-194,-1.2840879005
33208,2,総社市,66855,66201,654,0.9879004849,211.9,315.5,24863,23459,1404,5.9849098427
33209,2,高梁市,32075,34963,-2888,-8.2601607414,546.99,58.6,13481,14121,-640,-4.5322569223
33210,2,新見市,30658,33870,-3212,-9.483318571,793.29,38.6,11648,12208,-560,-4.5871559633
33211,2,備前市,35179,37839,-2660,-7.0297840852,258.17,136.3,13878,14136,-258,-1.8251273345
33212,2,瀬戸内市,36975,37852,-877,-2.3169185248,125.45,294.7,13839,13343,496,3.7173049539
33213,2,赤磐市,43214,43458,-244,-0.5614616411,209.36,206.4,15730,15274,456,2.9854654969
33214,2,真庭市,46124,48964,-2840,-5.8001797239,828.53,55.7,16084,16458,-374,-2.2724510876
33215,2,美作市,27977,30498,-2521,-8.2661158109,429.29,65.2,10881,11205,-324,-2.8915662651
33216,2,浅口市,34235,36114,-1879,-5.2029683779,66.46,515.1,12463,12280,183,1.490228013
33346,3,和気町,14412,15362,-950,-6.1840906132,144.21,99.9,5236,5394,-158,-2.929180571
33423,3,早島町,12154,12214,-60,-0.4912395612,7.62,1595,4349,4200,149,3.5476190476
33445,3,里庄町,10929,10916,13,0.1190912422,12.23,893.6,4027,3795,232,6.1133069829
33461,3,矢掛町,14201,15092,-891,-5.9037900875,90.62,156.7,4955,4947,8,0.1617141702
33586,3,新庄村,866,957,-91,-9.5088819227,67.11,12.9,330,342,-12,-3.5087719298
33606,3,鏡野町,12847,13580,-733,-5.3976435935,419.68,30.6,4669,4725,-56,-1.1851851852
33622,3,勝央町,11125,11195,-70,-0.6252791425,54.05,205.8,4054,3928,126,3.2077393075
33623,3,奈義町,5906,6085,-179,-2.9416598192,69.52,85,1978,1989,-11,-0.5530417295
33643,3,西粟倉村,1472,1520,-48,-3.1578947368,57.97,25.4,561,557,4,0.7181328546
33663,3,久米南町,4907,5296,-389,-7.3451661631,78.65,62.4,1893,1957,-64,-3.2703117016
33666,3,美咲町,14432,15642,-1210,-7.735583685,232.17,62.2,5258,5531,-273,-4.9358163081
33681,3,吉備中央町,11950,13033,-1083,-8.3096754393,268.78,44.5,4374,4460,-86,-1.9282511211
34100,1,広島市,1194034,1173843,20191,1.7200767053,906.53,1317.1,531605,512907,18698,3.6454951872
34101,0,広島市 中区,136640,130482,6158,4.7194249015,15.32,8919.1,76889,73281,3608,4.9235135983
34102,0,広島市 東区,120155,120751,-596,-0.4935776929,39.42,3048.1,51790,50605,1185,2.3416658433
34103,0,広島市 南区,142728,138190,4538,3.2838845068,26.3,5426.9,68785,66357,2428,3.6589960366
34104,0,広島市 西区,190929,186985,3944,2.1092601011,35.61,5361.7,90461,87222,3239,3.7135126459
34105,0,広島市 安佐南区,242512,233733,8779,3.7559950884,117.24,2068.5,99411,95188,4223,4.4364835904
34106,0,広島市 安佐北区,145018,149633,-4615,-3.0842127071,353.33,410.4,57151,56550,601,1.0627763042
34107,0,広島市 安芸区,79353,78789,564,0.7158359669,94.08,843.5,31302,30310,992,3.2728472451
34108,0,広島市 佐伯区,136699,135280,1419,1.0489355411,225.22,607,55816,53394,2422,4.5360901974
34202,2,呉市,228552,239973,-11421,-4.7592854196,352.8,647.8,97412,98654,-1242,-1.2589454052
34203,2,竹原市,26426,28644,-2218,-7.7433319369,118.23,223.5,11204,11525,-321,-2.7852494577
34204,2,三原市,96194,100509,-4315,-4.2931478773,471.55,204,39888,40247,-359,-0.8919919497
34205,2,尾道市,138626,145202,-6576,-4.5288632388,285.09,486.3,57759,58772,-1013,-1.7236098823
34207,2,福山市,464811,461357,3454,0.7486610152,518.14,897.1,185555,178718,6837,3.825579964
34208,2,府中市,40069,42563,-2494,-5.8595493739,195.75,204.7,15039,15122,-83,-0.5488691972
34209,2,三次市,53615,56605,-2990,-5.2822188853,778.14,68.9,21376,21786,-410,-1.8819425319
34210,2,庄原市,37000,40244,-3244,-8.0608289434,1246.49,29.7,14455,15269,-814,-5.331062938
34211,2,大竹市,27865,28836,-971,-3.3673186295,78.66,354.2,11749,11851,-102,-0.8606868619
34212,2,東広島市,192907,190135,2772,1.4579114839,635.16,303.7,84847,80986,3861,4.7674906774
34213,2,廿日市市,114906,114038,868,0.7611497922,489.48,234.8,46039,44644,1395,3.1247200072
34214,2,安芸高田市,29488,31487,-1999,-6.3486518246,537.75,54.8,11657,11804,-147,-1.2453405625
34215,2,江田島市,24339,27031,-2692,-9.9589360364,100.7,241.7,10741,11451,-710,-6.2003318487
34302,3,府中町,51053,50442,611,1.2112921772,10.41,4904.2,21109,20237,872,4.308939072
34304,3,海田町,28667,28475,192,0.6742756804,13.79,2078.8,12246,11667,579,4.962715351
34307,3,熊野町,23755,24533,-778,-3.1712387397,33.76,703.6,9430,9291,139,1.496071467
34309,3,坂町,12747,13262,-515,-3.8832755241,15.69,812.4,5132,5183,-51,-0.9839861084
34368,3,安芸太田町,6472,7255,-783,-10.7925568573,341.89,18.9,2781,3017,-236,-7.8223400729
34369,3,北広島町,18918,19969,-1051,-5.2631578947,646.2,29.3,7728,7699,29,0.3766722951
34431,3,大崎上島町,7992,8448,-456,-5.3977272727,43.11,185.4,3898,3880,18,0.4639175258
34462,3,世羅町,16337,17549,-1212,-6.9063764317,278.14,58.7,6242,6504,-262,-4.0282902829
34545,3,神石高原町,9217,10350,-1133,-10.9468599034,381.98,24.1,3533,3753,-220,-5.861977085
35201,2,下関市,268517,280947,-12430,-4.4243220252,715.89,375.1,116298,118178,-1880,-1.5908206265
35202,2,宇部市,169429,173772,-4343,-2.4992518933,286.65,591.1,73225,72447,778,1.0738884978
35203,2,山口市,197422,196628,794,0.4038082064,1023.23,192.9,84994,81299,3695,4.5449513524
35204,2,萩市,49560,53747,-4187,-7.7902022438,698.31,71,21620,22243,-623,-2.8008811761
35206,2,防府市,115942,116611,-669,-0.5737023094,189.37,612.3,47573,46851,722,1.5410556872
35207,2,下松市,55812,55012,800,1.4542281684,89.35,624.6,23757,22653,1104,4.8735266852
35208,2,岩国市,136757,143857,-7100,-4.9354567383,873.72,156.5,59080,59486,-406,-0.6825135326
35210,2,光市,51369,53004,-1635,-3.0846728549,92.13,557.6,20953,20913,40,0.1912685889
35211,2,長門市,35439,38349,-2910,-7.5882030822,357.29,99.2,14666,15143,-477,-3.1499702833
35212,2,柳井市,32945,34730,-1785,-5.1396487187,140.05,235.2,14170,14527,-357,-2.4574929442
35213,2,美祢市,26159,28630,-2471,-8.630806846,472.64,55.3,10095,10534,-439,-4.1674577558
35215,2,周南市,144842,149487,-4645,-3.1072936108,656.29,220.7,61999,61841,158,0.255493928
35216,2,山陽小野田市,62671,64550,-1879,-2.9109217661,133.09,470.9,25740,25536,204,0.7988721805
35305,3,周防大島町,17199,19084,-1885,-9.8773841962,138.09,124.5,8038,8786,-748,-8.513544275
35321,3,和木町,6285,6378,-93,-1.4581373471,10.58,594,2593,2589,4,0.1544998069
35341,3,上関町,2803,3332,-529,-15.8763505402,34.69,80.8,1459,1668,-209,-12.5299760192
35343,3,田布施町,15317,15986,-669,-4.1849117978,50.42,303.8,6131,6115,16,0.2616516762
35344,3,平生町,12798,13491,-693,-5.1367578386,34.58,370.1,4951,5044,-93,-1.8437747819
35502,3,阿武町,3463,3743,-280,-7.4806305103,115.95,29.9,1492,1579,-87,-5.5098163395
36201,2,徳島市,258554,264548,-5994,-2.2657513948,191.25,1351.9,115015,111675,3340,2.9908215805
36202,2,鳴門市,59101,61513,-2412,-3.9211223644,135.66,435.7,23234,22994,240,1.0437505436
36203,2,小松島市,38755,40614,-1859,-4.5772393756,45.37,854.2,15233,15201,32,0.2105124663
36204,2,阿南市,73019,76063,-3044,-4.0019457555,279.25,261.5,27193,26910,283,1.0516536603
36205,2,吉野川市,41466,44020,-2554,-5.8019082235,144.14,287.7,15714,15794,-80,-0.5065214638
36206,2,阿波市,37202,39247,-2045,-5.2105893444,191.11,194.7,13108,13252,-144,-1.0866284334
36207,2,美馬市,30501,32484,-1983,-6.1045437754,367.14,83.1,11440,11648,-208,-1.7857142857
36208,2,三好市,26836,29951,-3115,-10.4003205235,721.42,37.2,11311,12043,-732,-6.0782197127
36301,3,勝浦町,5301,5765,-464,-8.0485689506,69.83,75.9,1860,1881,-21,-1.1164274322
36302,3,上勝町,1545,1783,-238,-13.3482893999,109.63,14.1,732,763,-31,-4.0629095675
36321,3,佐那河内村,2289,2588,-299,-11.5533230294,42.28,54.1,793,834,-41,-4.9160671463
36341,3,石井町,25590,25954,-364,-1.4024813131,28.85,887,9327,8933,394,4.4106123363
36342,3,神山町,5300,6038,-738,-12.2225902617,173.3,30.6,2156,2351,-195,-8.2943428328
36368,3,那賀町,8402,9318,-916,-9.8304357158,694.98,12.1,3481,3708,-227,-6.1218985976
36383,3,牟岐町,4259,4826,-567,-11.7488603398,56.62,75.2,1871,2059,-188,-9.1306459446
36387,3,美波町,7092,7765,-673,-8.6670959433,140.8,50.4,2901,3097,-196,-6.3287051986
36388,3,海陽町,9283,10446,-1163,-11.1334482098,327.65,28.3,4198,4470,-272,-6.0850111857
36401,3,松茂町,15204,15070,134,0.8891838089,14.24,1067.7,5881,5602,279,4.9803641557
36402,3,北島町,22446,21658,788,3.6383784283,8.74,2568.2,8824,8269,555,6.7118152134
36403,3,藍住町,34626,33338,1288,3.8634591157,16.27,2128.2,13133,12098,1035,8.5551330798
36404,3,板野町,13358,14241,-883,-6.2004072748,36.22,368.8,4930,4897,33,0.6738819686
36405,3,上板町,12039,12727,-688,-5.4058301249,34.58,348.1,4256,4249,7,0.1647446458
36468,3,つるぎ町,8927,10490,-1563,-14.8999046711,194.84,45.8,3838,4286,-448,-10.4526364909
36489,3,東みよし町,14638,15044,-406,-2.6987503324,122.48,119.5,5325,5280,45,0.8522727273
37201,2,高松市,420748,419429,1319,0.3144751555,375.41,1120.8,182047,174278,7769,4.4578202642
37202,2,丸亀市,110010,110473,-463,-0.4191069311,111.78,984.2,43853,42983,870,2.0240560221
37203,2,坂出市,53164,55621,-2457,-4.4173963072,92.49,574.8,21361,21394,-33,-0.1542488548
37204,2,善通寺市,32927,33817,-890,-2.631812402,39.93,824.6,12977,12987,-10,-0.077000077
37205,2,観音寺市,59409,62690,-3281,-5.2336895837,117.84,504.1,21984,22476,-492,-2.1890016017
37206,2,さぬき市,50272,53000,-2728,-5.1471698113,158.63,316.9,19752,19698,54,0.2741395065
37207,2,東かがわ市,31031,33625,-2594,-7.7144981413,152.83,203,12441,12754,-313,-2.454132037
37208,2,三豊市,65524,68512,-2988,-4.3612797758,222.71,294.2,22761,22871,-110,-0.480958419
37322,3,土庄町,14002,15123,-1121,-7.4125504199,74.37,188.3,6061,6297,-236,-3.7478164205
37324,3,小豆島町,14862,16152,-1290,-7.9866270431,95.59,155.5,6411,6716,-305,-4.5413936867
37341,3,三木町,27684,28464,-780,-2.7403035413,75.78,365.3,10667,10639,28,0.2631826299
37364,3,直島町,3139,3325,-186,-5.5939849624,14.22,220.7,1519,1510,9,0.5960264901
37386,3,宇多津町,18952,18434,518,2.8100249539,8.1,2339.8,8465,8050,415,5.1552795031
37387,3,綾川町,23610,24625,-1015,-4.1218274112,109.75,215.1,8548,8409,139,1.6529908431
37403,3,琴平町,9186,9967,-781,-7.8358583325,8.47,1084.5,3708,3880,-172,-4.4329896907
37404,3,多度津町,23366,23498,-132,-0.5617499362,24.38,958.4,9551,9177,374,4.0754059061
37406,3,まんのう町,18377,19087,-710,-3.7198092943,194.45,94.5,6445,6355,90,1.4162077105
38201,2,松山市,514865,517231,-2366,-0.4574358459,429.37,1199.1,230509,224178,6331,2.8240951387
38202,2,今治市,158114,166532,-8418,-5.0548843466,419.13,377.2,67105,68249,-1144,-1.6762150361
38203,2,宇和島市,77465,84210,-6745,-8.0097375609,468.16,165.5,32732,34041,-1309,-3.8453629447
38204,2,八幡浜市,34951,38370,-3419,-8.9106072452,132.68,263.4,14995,15849,-854,-5.3883525774
38205,2,新居浜市,119903,121735,-1832,-1.5049082022,234.46,511.4,50653,50377,276,0.5478690672
38206,2,西条市,108174,112091,-3917,-3.4944821618,509.98,212.1,44595,44630,-35,-0.0784225857
38207,2,大洲市,44086,47157,-3071,-6.5122887376,432.22,102,18057,18410,-353,-1.917436176
38210,2,伊予市,36827,38017,-1190,-3.1301786043,194.44,189.4,14003,13959,44,0.3152088258
38213,2,四国中央市,87413,90187,-2774,-3.0758313282,421.24,207.5,34999,34951,48,0.1373351263
38214,2,西予市,38919,42080,-3161,-7.5118821293,514.34,75.7,16365,17096,-731,-4.2758540009
38215,2,東温市,34613,35253,-640,-1.8154483306,211.3,163.8,13978,13490,488,3.6174944403
38356,3,上島町,7135,7648,-513,-6.7076359833,30.38,234.9,3386,3618,-232,-6.4123825318
38386,3,久万高原町,8447,9644,-1197,-12.4118622978,583.69,14.5,4052,4468,-416,-9.3106535363
38401,3,松前町,30064,30359,-295,-0.9717052604,20.41,1473,11525,11308,217,1.9189954015
38402,3,砥部町,21239,21981,-742,-3.3756426004,101.59,209.1,8356,8272,84,1.0154738878
38422,3,内子町,16742,18045,-1303,-7.2208367969,299.43,55.9,6475,6722,-247,-3.6745016364
38442,3,伊方町,9626,10882,-1256,-11.5419959566,93.98,102.4,4488,4884,-396,-8.1081081081
38484,3,松野町,4072,4377,-305,-6.9682430889,98.45,41.4,1675,1748,-73,-4.176201373
38488,3,鬼北町,10705,11633,-928,-7.97730594,241.88,44.3,4614,4801,-187,-3.8950218704
38506,3,愛南町,21902,24061,-2159,-8.97302689,238.99,91.6,9410,9837,-427,-4.340754295
39201,2,高知市,337190,343393,-6203,-1.8063851039,308.99,1091.3,153594,150857,2737,1.8143009605
39202,2,室戸市,13524,15210,-1686,-11.0848126233,248.18,54.5,6512,6996,-484,-6.9182389937
39203,2,安芸市,17577,19547,-1970,-10.0782728807,317.21,55.4,7604,8111,-507,-6.2507705585
39204,2,南国市,47982,49472,-1490,-3.0118046572,125.3,382.9,19481,19377,104,0.5367187903
39205,2,土佐市,27038,28686,-1648,-5.7449626996,91.49,295.5,10255,10544,-289,-2.7408952959
39206,2,須崎市,22606,24698,-2092,-8.4703214835,135.44,166.9,9121,9323,-202,-2.1666845436
39208,2,宿毛市,20907,22610,-1703,-7.5320654578,286.19,73.1,8925,9213,-288,-3.1260175838
39209,2,土佐清水市,13778,16029,-2251,-14.043296525,266.34,51.7,6586,7216,-630,-8.7305986696
39210,2,四万十市,34313,35933,-1620,-4.5083906159,632.29,54.3,14771,14874,-103,-0.6924835283
39211,2,香南市,32961,33830,-869,-2.5687259829,126.48,260.6,12953,12877,76,0.5901995806
39212,2,香美市,27513,28766,-1253,-4.3558367517,537.86,51.2,11979,12245,-266,-2.1723152307
39301,3,東洋町,2584,2947,-363,-12.31761113,74.06,34.9,1382,1461,-79,-5.4072553046
39302,3,奈半利町,3326,3542,-216,-6.0982495765,28.36,117.3,1474,1480,-6,-0.4054054054
39303,3,田野町,2733,2932,-199,-6.7871759891,6.53,418.5,1188,1214,-26,-2.1416803954
39304,3,安田町,2631,2970,-339,-11.4141414141,52.36,50.2,1146,1203,-57,-4.7381546135
39305,3,北川村,1294,1367,-73,-5.3401609364,196.73,6.6,582,598,-16,-2.6755852843
39306,3,馬路村,823,1013,-190,-18.7561697927,165.48,5,391,450,-59,-13.1111111111
39307,3,芸西村,3858,4048,-190,-4.6936758893,39.6,97.4,1488,1490,-2,-0.1342281879
39341,3,本山町,3573,4103,-530,-12.9173775286,134.22,26.6,1688,1758,-70,-3.9817974972
39344,3,大豊町,3962,4719,-757,-16.0415342234,315.06,12.6,2050,2312,-262,-11.3321799308
39363,3,土佐町,3997,4358,-361,-8.2836163378,212.13,18.8,1734,1799,-65,-3.6131183991
39364,3,大川村,396,411,-15,-3.6496350365,95.27,4.2,210,213,-3,-1.4084507042
39386,3,いの町,22767,25062,-2295,-9.157289921,470.97,48.3,9198,9772,-574,-5.8739255014
39387,3,仁淀川町,5551,6500,-949,-14.6,333,16.7,2778,3074,-296,-9.6291476903
39401,3,中土佐町,6840,7591,-751,-9.8932946911,193.28,35.4,2916,3113,-197,-6.3283006746
39402,3,佐川町,13114,13951,-837,-5.9995699233,100.8,130.1,5237,5340,-103,-1.9288389513
39403,3,越知町,5795,6374,-579,-9.0837778475,111.95,51.8,2518,2641,-123,-4.6573267702
39405,3,檮原町,3608,3984,-376,-9.437751004,236.45,15.3,1560,1769,-209,-11.814584511
39410,3,日高村,5030,5447,-417,-7.6555902332,44.85,112.2,1968,2063,-95,-4.6049442559
39411,3,津野町,5794,6407,-613,-9.5676603715,197.85,29.3,2297,2406,-109,-4.5303408146
39412,3,四万十町,17325,18726,-1401,-7.4815764178,642.3,27,7454,7750,-296,-3.8193548387
39424,3,大月町,5095,5783,-688,-11.8969393049,102.94,49.5,2369,2573,-204,-7.9284881461
39427,3,三原村,1574,1681,-107,-6.3652587745,85.37,18.4,703,745,-42,-5.6375838926
39428,3,黒潮町,11217,12366,-1149,-9.2916060165,188.59,59.5,4899,5052,-153,-3.0285035629
40100,1,北九州市,961286,976846,-15560,-1.5928815801,491.95,1954,426325,420702,5623,1.3365755333
40101,0,北九州市 門司区,99637,104469,-4832,-4.6252955422,73.67,1352.5,43082,44232,-1150,-2.5999276542
40103,0,北九州市 若松区,82844,85167,-2323,-2.7275822795,71.31,1161.7,33692,33495,197,0.5881474847
40105,0,北九州市 戸畑区,59116,61583,-2467,-4.0059756751,16.61,3559.1,27797,28064,-267,-0.9513968073
40106,0,北九州市 小倉北区,181878,181936,-58,-0.0318793422,39.23,4636.2,91253,89036,2217,2.4900040433
40107,0,北九州市 小倉南区,212850,214793,-1943,-0.9045918629,171.74,1239.4,88497,86420,2077,2.4033788475
40108,0,北九州市 八幡東区,68844,71801,-2957,-4.1183270428,36.26,1898.6,31442,32142,-700,-2.1778358534
40109,0,北九州市 八幡西区,256117,257097,-980,-0.381179088,83.13,3080.9,110562,107313,3249,3.0275921836
40130,1,福岡市,1538681,1463743,74938,5.1196145771,343.39,4480.9,764820,707358,57462,8.1234678904
40131,0,福岡市 東区,306015,292199,13816,4.728284491,69.36,4412,141682,133165,8517,6.3958247287
40132,0,福岡市 博多区,228441,212527,15914,7.4879897613,31.63,7222.3,138832,124266,14566,11.7216294079
40133,0,福岡市 中央区,192688,178429,14259,7.9914139518,15.4,12512.2,116186,106966,9220,8.6195613559
40134,0,福岡市 南区,255797,247096,8701,3.521303461,30.98,8256.8,119637,112423,7214,6.4168364125
40135,0,福岡市 西区,206868,193280,13588,7.0302152318,84.17,2457.7,88142,78018,10124,12.9764926043
40136,0,福岡市 城南区,130995,128659,2336,1.815652228,15.99,8192.3,64606,62266,2340,3.7580702149
40137,0,福岡市 早良区,217877,211553,6324,2.9893218248,95.87,2272.6,95735,90254,5481,6.0728610366
40202,2,大牟田市,117360,123638,-6278,-5.0777269124,81.45,1440.9,49398,49936,-538,-1.0773790452
40203,2,久留米市,304552,302402,2150,0.7109741338,229.96,1324.4,121913,116664,5249,4.499245697
40204,2,直方市,57146,57686,-540,-0.9361023472,61.76,925.3,23281,22645,636,2.8085670126
40205,2,飯塚市,129146,131492,-2346,-1.784138959,214.07,603.3,54732,53451,1281,2.3965875288
40206,2,田川市,48441,50605,-2164,-4.2762572868,54.55,888,20955,21198,-243,-1.1463345599
40207,2,柳川市,67777,71375,-3598,-5.0409807356,77.15,878.5,23453,23333,120,0.5142930613
40210,2,八女市,64408,69057,-4649,-6.732119843,482.44,133.5,22109,22316,-207,-0.9275855888
40211,2,筑後市,48339,48512,-173,-0.3566127968,41.78,1157,17379,16628,751,4.5164782295
40212,2,大川市,34838,37448,-2610,-6.9696646016,33.62,1036.2,12709,12577,132,1.0495348652
40213,2,行橋市,70586,70468,118,0.1674518931,70.05,1007.7,28648,27634,1014,3.669392777
40214,2,豊前市,25940,27031,-1091,-4.0361066923,111.1,233.5,10070,10095,-25,-0.2476473502
40215,2,中間市,41796,44210,-2414,-5.4603030988,15.96,2618.8,17414,17801,-387,-2.1740351666
40216,2,小郡市,57983,58499,-516,-0.8820663601,45.51,1274.1,20964,20024,940,4.6943667599
40217,2,筑紫野市,101081,100172,909,0.9074392046,87.73,1152.2,39350,37703,1647,4.368352651
40218,2,春日市,110743,106780,3963,3.7113691703,14.15,7826.4,43720,41075,2645,6.4394400487
40219,2,大野城市,99525,95087,4438,4.6673046789,26.89,3701.2,39885,36778,3107,8.4479852085
40220,2,宗像市,96516,95501,1015,1.0628160962,119.91,804.9,38995,37077,1918,5.1730183132
40221,2,太宰府市,72168,70482,1686,2.3921001107,29.6,2438.1,29107,27850,1257,4.513464991
40223,2,古賀市,57959,57920,39,0.0673342541,42.07,1377.7,22320,21517,803,3.7319328903
40224,2,福津市,58781,55431,3350,6.0435496383,52.76,1114.1,22272,20482,1790,8.7393809198
40225,2,うきは市,29509,31640,-2131,-6.7351453856,117.46,251.2,9940,10219,-279,-2.7302084353
40226,2,宮若市,28112,30081,-1969,-6.5456600512,139.99,200.8,10737,11094,-357,-3.2179556517
40227,2,嘉麻市,38743,42589,-3846,-9.0305008335,135.11,286.8,15637,16472,-835,-5.0692083536
40228,2,朝倉市,52444,56355,-3911,-6.9399343448,246.71,212.6,19088,19064,24,0.1258917331
40229,2,みやま市,38139,40732,-2593,-6.3660021605,105.21,362.5,12941,13072,-131,-1.0021419829
40230,2,糸島市,96475,98435,-1960,-1.9911616803,215.7,447.3,34739,33765,974,2.884643862
40305,3,那珂川町,50004,49780,224,0.4499799116,74.95,667.2,18291,17619,672,3.8140643623
40341,3,宇美町,37927,38592,-665,-1.723155058,30.21,1255.4,13119,12867,252,1.9584984845
40342,3,篠栗町,31210,31318,-108,-0.3448496073,38.93,801.7,11539,11060,479,4.3309222423
40343,3,志免町,45256,43564,1692,3.8839408686,8.69,5207.8,17591,16617,974,5.8614671722
40344,3,須恵町,27263,26044,1219,4.6805406236,16.31,1671.6,9919,9077,842,9.2761925746
40345,3,新宮町,30344,24679,5665,22.9547388468,18.93,1603,10946,8865,2081,23.4743372814
40348,3,久山町,8225,8373,-148,-1.7675862893,37.44,219.7,2825,2657,168,6.3229205871
40349,3,粕屋町,45360,41997,3363,8.0077148368,14.13,3210.2,18005,16232,1773,10.9228684081
40381,3,芦屋町,14208,15369,-1161,-7.55416748,11.6,1224.8,5573,5891,-318,-5.3980648447
40382,3,水巻町,28997,30021,-1024,-3.4109456714,11.01,2633.7,12220,12087,133,1.1003557541
40383,3,岡垣町,31580,32119,-539,-1.6781344376,48.64,649.3,11784,11656,128,1.0981468771
40384,3,遠賀町,18877,19160,-283,-1.4770354906,22.15,852.2,7269,7056,213,3.018707483
40401,3,小竹町,7810,8602,-792,-9.2071611253,14.18,550.8,3331,3511,-180,-5.1267445172
40402,3,鞍手町,16007,17088,-1081,-6.326076779,35.6,449.6,6393,6510,-117,-1.797235023
40421,3,桂川町,13496,13863,-367,-2.6473346318,20.14,670.1,5226,5216,10,0.1917177914
40447,3,筑前町,29306,29155,151,0.5179214543,67.1,436.8,9767,9297,470,5.0553942132
40448,3,東峰村,2174,2432,-258,-10.6085526316,51.97,41.8,742,798,-56,-7.0175438596
40503,3,大刀洗町,15138,15284,-146,-0.9552473175,22.84,662.8,5008,4793,215,4.4857083246
40522,3,大木町,14176,14350,-174,-1.212543554,18.44,768.8,4556,4470,86,1.9239373602
40544,3,広川町,20183,20253,-70,-0.3456278082,37.94,532,7007,6799,208,3.0592734226
40601,3,香春町,10861,11685,-824,-7.0517757809,44.5,244.1,4429,4595,-166,-3.6126224157
40602,3,添田町,9924,10909,-985,-9.0292419103,132.2,75.1,4029,4215,-186,-4.4128113879
40604,3,糸田町,9020,9617,-597,-6.2077570968,8.04,1121.9,3814,3924,-110,-2.8032619776
40605,3,川崎町,16789,18264,-1475,-8.0759964958,36.14,464.6,7349,7693,-344,-4.4715975562
40608,3,大任町,5176,5503,-327,-5.9422133382,14.26,363,2052,2083,-31,-1.4882381181
40609,3,赤村,3022,3251,-229,-7.0439864657,31.98,94.5,1127,1157,-30,-2.5929127053
40610,3,福智町,22871,24714,-1843,-7.4573116452,42.06,543.8,8727,8998,-271,-3.0117803956
40621,3,苅田町,34963,36005,-1042,-2.8940424941,48.88,715.3,15341,15560,-219,-1.4074550129
40625,3,みやこ町,20243,21572,-1329,-6.1607639533,151.34,133.8,7527,7703,-176,-2.2848240945
40642,3,吉富町,6627,6792,-165,-2.4293286219,5.72,1158.6,2589,2645,-56,-2.1172022684
40646,3,上毛町,7458,7852,-394,-5.0178298523,62.44,119.4,2791,2843,-52,-1.8290538164
40647,3,築上町,18587,19544,-957,-4.8966434711,119.61,155.4,7250,7444,-194,-2.6061257389
41201,2,佐賀市,236372,237506,-1134,-0.477461622,431.84,547.4,93306,90435,2871,3.1746558302
41202,2,唐津市,122785,126926,-4141,-3.2625309235,487.58,251.8,43872,43651,221,0.5062885157
41203,2,鳥栖市,72902,69074,3828,5.5418826186,71.72,1016.5,27630,25219,2411,9.5602521908
41204,2,多久市,19749,21404,-1655,-7.7321995889,96.96,203.7,6847,7100,-253,-3.5633802817
41205,2,伊万里市,55238,57161,-1923,-3.3641818723,255.25,216.4,19698,19614,84,0.4282655246
41206,2,武雄市,49062,50699,-1637,-3.2288605298,195.4,251.1,16932,16674,258,1.5473191796
41207,2,鹿島市,29684,30720,-1036,-3.3723958333,112.12,264.8,10124,10055,69,0.6862257583
41208,2,小城市,44259,45133,-874,-1.9364987925,95.81,461.9,14769,14305,464,3.2436211115
41209,2,嬉野市,27336,28984,-1648,-5.6858956666,126.41,216.2,9214,9314,-100,-1.073652566
41210,2,神埼市,31842,32899,-1057,-3.2128636129,125.13,254.5,10913,10741,172,1.6013406573
41327,3,吉野ヶ里町,16411,16405,6,0.0365742152,43.99,373.1,5891,5478,413,7.5392479007
41341,3,基山町,17501,17837,-336,-1.8837248416,22.15,790.1,6321,6025,296,4.9128630705
41345,3,上峰町,9283,9224,59,0.6396357329,12.8,725.2,3260,3074,186,6.0507482108
41346,3,みやき町,25278,26175,-897,-3.4269340974,51.92,486.9,8638,8437,201,2.3823633993
41387,3,玄海町,5902,6379,-477,-7.4776610754,35.92,164.3,1918,1959,-41,-2.0929045431
41401,3,有田町,20148,20929,-781,-3.731664198,65.85,306,6900,6916,-16,-0.2313475998
41423,3,大町町,6777,7369,-592,-8.0336544986,11.5,589.3,2560,2694,-134,-4.9740163326
41424,3,江北町,9583,9515,68,0.7146610615,24.49,391.3,3225,3076,149,4.843953186
41425,3,白石町,23941,25607,-1666,-6.5060335065,99.56,240.5,7253,7346,-93,-1.2659950994
41441,3,太良町,8779,9842,-1063,-10.8006502743,74.3,118.2,2838,2925,-87,-2.9743589744
42201,2,長崎市,429508,443766,-14258,-3.2129545752,405.86,1058.3,189419,187685,1734,0.9238884301
42202,2,佐世保市,255439,261101,-5662,-2.168509504,426.06,599.5,105011,104583,428,0.4092443323
42203,2,島原市,45436,47455,-2019,-4.2545569487,82.97,547.6,17068,17039,29,0.1701977816
42204,2,諫早市,138078,140752,-2674,-1.8997953848,341.79,404,51897,50989,908,1.7807762459
42205,2,大村市,92757,90517,2240,2.4746732658,126.62,732.6,36070,34044,2026,5.9511220773
42207,2,平戸市,31920,34905,-2985,-8.5517834121,235.08,135.8,12421,12885,-464,-3.6010865347
42208,2,松浦市,23309,25145,-1836,-7.3016504275,130.55,178.5,8994,9214,-220,-2.3876709355
42209,2,対馬市,31457,34407,-2950,-8.5738367193,708.63,44.4,13393,13813,-420,-3.0406139144
42210,2,壱岐市,27103,29377,-2274,-7.740749566,139.42,194.4,10002,10401,-399,-3.8361695991
42211,2,五島市,37327,40622,-3295,-8.1113682241,420.05,88.9,17425,18382,-957,-5.2061799587
42212,2,西海市,28691,31176,-2485,-7.9708750321,241.59,118.8,11494,11875,-381,-3.2084210526
42213,2,雲仙市,44115,47245,-3130,-6.6250396867,214.31,205.8,15376,15863,-487,-3.0700371935
42214,2,南島原市,46535,50363,-3828,-7.6008180609,170.11,273.6,16664,17160,-496,-2.8904428904
42307,3,長与町,42548,42535,13,0.0305630657,28.73,1481,16237,15478,759,4.9037343326
42308,3,時津町,29804,30110,-306,-1.0162736632,20.94,1423.3,11137,10787,350,3.2446463335
42321,3,東彼杵町,8298,8903,-605,-6.7954622038,74.29,111.7,2744,2747,-3,-0.1092100473
42322,3,川棚町,14067,14651,-584,-3.9860760358,37.35,376.6,5103,5144,-41,-0.7970451011
42323,3,波佐見町,14891,15227,-336,-2.2066066855,56,265.9,4957,4780,177,3.7029288703
42383,3,小値賀町,2560,2849,-289,-10.1439101439,25.53,100.3,1210,1287,-77,-5.9829059829
42391,3,佐々町,13626,13599,27,0.1985440106,32.27,422.2,5102,4884,218,4.4635544636
42411,3,新上五島町,19718,22074,-2356,-10.6731901785,213.94,92.2,8996,9620,-624,-6.4864864865
43100,1,熊本市,740822,734474,6348,0.8642919967,390.32,1898,315456,302413,13043,4.3129759633
43101,0,熊本市 中央区,186300,184353,1947,1.0561260191,25.45,7320.2,95754,92242,3512,3.8073762494
43102,0,熊本市 東区,190451,188082,2369,1.2595570017,50.19,3794.6,78406,74942,3464,4.6222411999
43103,0,熊本市 西区,93171,93805,-634,-0.6758701562,89.33,1043,38944,37610,1334,3.5469290082
43104,0,熊本市 南区,127769,122600,5169,4.2161500816,110.01,1161.4,47144,43499,3645,8.3795029771
43105,0,熊本市 北区,143131,145634,-2503,-1.7186920637,115.34,1240.9,55208,54120,1088,2.0103473762
43202,2,八代市,127472,132266,-4794,-3.6245142365,681.36,187.1,47972,47458,514,1.0830629188
43203,2,人吉市,33880,35611,-1731,-4.8608576002,210.55,160.9,13849,14001,-152,-1.0856367402
43204,2,荒尾市,53407,55321,-1914,-3.4598073064,57.37,930.9,20910,20898,12,0.0574217628
43205,2,水俣市,25411,26978,-1567,-5.8084365038,163.29,155.6,10639,10893,-254,-2.3317726981
43206,2,玉名市,66782,69541,-2759,-3.9674436663,152.6,437.6,24474,24344,130,0.5340124877
43208,2,山鹿市,52264,55391,-3127,-5.6453214421,299.69,174.4,19145,19308,-163,-0.844209654
43210,2,菊池市,48167,50194,-2027,-4.0383312747,276.85,174,16949,16706,243,1.4545672214
43211,2,宇土市,37026,37727,-701,-1.8580857211,74.3,498.3,13285,12808,477,3.7242348532
43212,2,上天草市,27006,29902,-2896,-9.684970905,126.91,212.8,10477,10994,-517,-4.7025650355
43213,2,宇城市,59756,61878,-2122,-3.429328679,188.61,316.8,21432,21077,355,1.6843004223
43214,2,阿蘇市,27018,28444,-1426,-5.0133595837,376.3,71.8,10078,10100,-22,-0.2178217822
43215,2,天草市,82739,89065,-6326,-7.1026778196,683.78,121,33224,34272,-1048,-3.0578898226
43216,2,合志市,58370,55002,3368,6.123413694,53.19,1097.4,20560,18913,1647,8.7082958811
43348,3,美里町,10333,11388,-1055,-9.2641376888,144,71.8,3611,3791,-180,-4.7480875758
43364,3,玉東町,5265,5554,-289,-5.203456968,24.33,216.4,1825,1825,0,0
43367,3,南関町,9786,10564,-778,-7.3646346081,68.92,142,3560,3681,-121,-3.2871502309
43368,3,長洲町,15889,16594,-705,-4.2485235627,19.43,817.8,6139,6051,88,1.4543050735
43369,3,和水町,10191,11247,-1056,-9.3891704455,98.78,103.2,3512,3624,-112,-3.0905077263
43403,3,大津町,33452,31234,2218,7.1012358327,99.1,337.6,12705,11478,1227,10.6900156822
43404,3,菊陽町,40984,37734,3250,8.6129220332,37.46,1094.1,15950,14124,1826,12.9283489097
43423,3,南小国町,4048,4429,-381,-8.6023933168,115.9,34.9,1642,1702,-60,-3.5252643948
43424,3,小国町,7187,7877,-690,-8.7596800812,136.94,52.5,2805,2875,-70,-2.4347826087
43425,3,産山村,1510,1606,-96,-5.9775840598,60.81,24.8,526,575,-49,-8.5217391304
43428,3,高森町,6325,6716,-391,-5.8219178082,175.06,36.1,2463,2524,-61,-2.4167987322
43432,3,西原村,6802,6792,10,0.1472320377,77.22,88.1,2341,2221,120,5.4029716344
43433,3,南阿蘇村,11503,11972,-469,-3.9174741062,137.32,83.8,4676,4610,66,1.431670282
43441,3,御船町,17237,17888,-651,-3.6393112701,99.03,174.1,6317,6224,93,1.4942159383
43442,3,嘉島町,9054,8676,378,4.356846473,16.65,543.8,3170,2930,240,8.1911262799
43443,3,益城町,33611,32676,935,2.8614273473,65.68,511.7,11477,10935,542,4.9565614998
43444,3,甲佐町,10717,11181,-464,-4.1498971469,57.93,185,3710,3693,17,0.4603303547
43447,3,山都町,15149,16981,-1832,-10.7885283552,544.67,27.8,5594,5906,-312,-5.2827632916
43468,3,氷川町,11994,12715,-721,-5.6704679512,33.36,359.5,3878,3973,-95,-2.3911401963
43482,3,芦北町,17661,19316,-1655,-8.5680265065,233.98,75.5,6481,6796,-315,-4.6350794585
43484,3,津奈木町,4673,5062,-389,-7.6847096009,34.09,137.1,1744,1826,-82,-4.4906900329
43501,3,錦町,10766,11075,-309,-2.7900677201,85.04,126.6,3641,3602,39,1.0827318157
43505,3,多良木町,9791,10554,-763,-7.2294864506,165.86,59,3537,3614,-77,-2.1306032097
43506,3,湯前町,3985,4375,-390,-8.9142857143,48.37,82.4,1479,1515,-36,-2.3762376238
43507,3,水上村,2232,2405,-173,-7.1933471933,190.96,11.7,822,854,-32,-3.7470725995
43510,3,相良村,4468,4934,-466,-9.4446696392,94.54,47.3,1504,1529,-25,-1.6350555919
43511,3,五木村,1055,1205,-150,-12.4481327801,252.92,4.2,461,503,-42,-8.3499005964
43512,3,山江村,3422,3681,-259,-7.036131486,121.19,28.2,1149,1163,-14,-1.203783319
43513,3,球磨村,3698,4249,-551,-12.9677571193,207.58,17.8,1368,1489,-121,-8.1262592344
43514,3,あさぎり町,15523,16638,-1115,-6.7015266258,159.56,97.3,5298,5414,-116,-2.1425932767
43531,3,苓北町,7739,8314,-575,-6.9160452249,67.57,114.5,2895,3002,-107,-3.564290473
44201,2,大分市,478146,474094,4052,0.8546828266,502.39,951.7,203515,195623,7892,4.0342904464
44202,2,別府市,122138,125385,-3247,-2.5896239582,125.34,974.5,55624,56070,-446,-0.7954342786
44203,2,中津市,83965,84312,-347,-0.4115665623,491.53,170.8,35785,34574,1211,3.5026320356
44204,2,日田市,66523,70940,-4417,-6.2263884973,666.03,99.9,25238,25551,-313,-1.2250009784
44205,2,佐伯市,72211,76951,-4740,-6.1597640057,903.11,80,29574,30511,-937,-3.0710235653
44206,2,臼杵市,38748,41469,-2721,-6.5615278883,291.2,133.1,15077,15394,-317,-2.0592438612
44207,2,津久見市,17969,19917,-1948,-9.7805894462,79.48,226.1,7518,7978,-460,-5.7658561043
44208,2,竹田市,22332,24423,-2091,-8.5616017688,477.53,46.8,9100,9588,-488,-5.0896954526
44209,2,豊後高田市,22853,23906,-1053,-4.4047519451,206.24,110.8,9572,9665,-93,-0.9622348681
44210,2,杵築市,30185,32083,-1898,-5.9159056198,280.08,107.8,12084,12181,-97,-0.796322141
44211,2,宇佐市,56258,59008,-2750,-4.6603850325,439.05,128.1,22524,22869,-345,-1.5085924177
44212,2,豊後大野市,36584,39452,-2868,-7.26959343,603.14,60.7,14326,14854,-528,-3.5545980881
44213,2,由布市,34262,34702,-440,-1.2679384474,319.32,107.3,13291,12874,417,3.239086531
44214,2,国東市,28647,32002,-3355,-10.4837197675,318.08,90.1,12112,13139,-1027,-7.8164243854
44322,3,姫島村,1991,2189,-198,-9.0452261307,6.98,285.2,879,913,-34,-3.7239868565
44341,3,日出町,28058,28221,-163,-0.5775840686,73.32,382.7,10855,10517,338,3.2138442522
44461,3,九重町,9645,10421,-776,-7.4465022551,271.37,35.5,3473,3601,-128,-3.5545681755
44462,3,玖珠町,15823,17054,-1231,-7.2182479184,286.51,55.2,5988,6149,-161,-2.6183119206
45201,2,宮崎市,401138,400583,555,0.1385480662,643.67,623.2,175408,170136,5272,3.0986975126
45202,2,都城市,165029,169602,-4573,-2.6963125435,653.36,252.6,69965,69856,109,0.1560352726
45203,2,延岡市,125159,131182,-6023,-4.5913311277,868.02,144.2,51751,52454,-703,-1.3402219087
45204,2,日南市,54090,57689,-3599,-6.2386243478,536.11,100.9,22678,23228,-550,-2.367831927
45205,2,小林市,46221,48270,-2049,-4.2448725917,562.95,82.1,19498,19576,-78,-0.3984470781
45206,2,日向市,61761,63223,-1462,-2.3124495832,336.93,183.3,24815,24791,24,0.096809326
45207,2,串間市,18779,20453,-1674,-8.1846183934,295.16,63.6,7952,8417,-465,-5.5245336818
45208,2,西都市,30683,32614,-1931,-5.9207702214,438.79,69.9,12004,12197,-193,-1.5823563171
45209,2,えびの市,19538,21606,-2068,-9.5714153476,282.93,69.1,8568,9078,-510,-5.6179775281
45341,3,三股町,25404,24800,604,2.435483871,110.02,230.9,9967,9503,464,4.882668631
45361,3,高原町,9300,10000,-700,-7,85.39,108.9,3914,4042,-128,-3.1667491341
45382,3,国富町,19606,20909,-1303,-6.2317662251,130.63,150.1,7606,7746,-140,-1.8073844565
45383,3,綾町,7345,7224,121,1.6749723145,95.19,77.2,2915,2851,64,2.2448263767
45401,3,高鍋町,21025,21733,-708,-3.2577186767,43.8,480,8678,8668,10,0.1153668666
45402,3,新富町,17373,18092,-719,-3.9741322131,61.53,282.4,6376,6362,14,0.220056586
45403,3,西米良村,1089,1241,-152,-12.248186946,271.51,4,509,598,-89,-14.8829431438
45404,3,木城町,5231,5177,54,1.04307514,145.96,35.8,1958,1897,61,3.2156035846
45405,3,川南町,16109,17009,-900,-5.2913163619,90.12,178.8,5936,6020,-84,-1.3953488372
45406,3,都農町,10391,11137,-746,-6.6983927449,102.11,101.8,3940,4024,-84,-2.0874751491
45421,3,門川町,18183,18854,-671,-3.5589264877,120.51,150.9,6824,6840,-16,-0.2339181287
45429,3,諸塚村,1739,1882,-143,-7.5982996812,187.56,9.3,688,719,-31,-4.3115438108
45430,3,椎葉村,2808,3092,-284,-9.1849935317,537.29,5.2,1128,1203,-75,-6.2344139651
45431,3,美郷町,5480,6248,-768,-12.2919334187,448.84,12.2,2332,2516,-184,-7.3131955485
45441,3,高千穂町,12755,13723,-968,-7.0538511987,237.54,53.7,4678,4794,-116,-2.4196912808
45442,3,日之影町,3946,4463,-517,-11.5841362312,277.67,14.2,1493,1621,-128,-7.8963602714
45443,3,五ヶ瀬町,3887,4427,-540,-12.1978766659,171.73,22.6,1277,1368,-91,-6.6520467836
46201,2,鹿児島市,599814,605846,-6032,-0.9956325535,547.55,1095.5,270269,264686,5583,2.1092917646
46203,2,鹿屋市,103608,105070,-1462,-1.3914533168,448.15,231.2,44911,44404,507,1.141789028
46204,2,枕崎市,22046,23638,-1592,-6.7349183518,74.78,294.8,10062,10434,-372,-3.5652673951
46206,2,阿久根市,21198,23154,-1956,-8.4477844001,134.29,157.9,9196,9830,-634,-6.4496439471
46208,2,出水市,53758,55621,-1863,-3.3494543428,329.98,162.9,22508,22555,-47,-0.2083795167
46210,2,指宿市,41831,44396,-2565,-5.7775475268,148.84,281,18509,19210,-701,-3.6491410724
46213,2,西之表市,15967,16951,-984,-5.8049672586,205.66,77.6,7368,7569,-201,-2.6555687673
46214,2,垂水市,15520,17248,-1728,-10.0185528757,162.12,95.7,6988,7470,-482,-6.452476573
46215,2,薩摩川内市,96076,99589,-3513,-3.5274980168,682.92,140.7,40686,41449,-763,-1.840816425
46216,2,日置市,49249,50822,-1573,-3.0951162882,253.01,194.7,19649,19916,-267,-1.3406306487
46217,2,曽於市,36557,39221,-2664,-6.7922796461,390.11,93.7,16134,16859,-725,-4.3003736876
46218,2,霧島市,125857,127487,-1630,-1.2785617357,603.18,208.7,54334,53971,363,0.6725834244
46219,2,いちき串木野市,29282,31144,-1862,-5.9786796815,112.3,260.7,12159,12315,-156,-1.2667478685
46220,2,南さつま市,35439,38704,-3265,-8.435820587,283.59,125,15361,16419,-1058,-6.4437541872
46221,2,志布志市,31479,33034,-1555,-4.7072712962,290.28,108.4,13869,14149,-280,-1.9789384409
46222,2,奄美市,43156,46121,-2965,-6.4287417879,308.27,140,19627,20114,-487,-2.4211991648
46223,2,南九州市,36352,39065,-2713,-6.9448355305,357.91,101.6,15349,16069,-720,-4.4806770801
46224,2,伊佐市,26810,29304,-2494,-8.5107835108,392.56,68.3,12110,12798,-688,-5.375839975
46225,2,姶良市,75173,74809,364,0.4865724712,231.25,325.1,31435,30478,957,3.1399698143
46303,3,三島村,407,418,-11,-2.6315789474,31.4,13,223,242,-19,-7.8512396694
46304,3,十島村,756,657,99,15.0684931507,101.14,7.5,427,396,31,7.8282828283
46392,3,さつま町,22400,24109,-1709,-7.0886390974,303.9,73.7,9690,9969,-279,-2.7986758953
46404,3,長島町,10431,11105,-674,-6.069338136,116.13,89.8,4137,4303,-166,-3.8577736463
46452,3,湧水町,10327,11595,-1268,-10.9357481673,144.29,71.6,4323,4653,-330,-7.0921985816
46468,3,大崎町,13241,14215,-974,-6.8519169891,100.67,131.5,6074,6380,-306,-4.7962382445
46482,3,東串良町,6530,6802,-272,-3.9988238753,27.78,235.1,2826,2964,-138,-4.6558704453
46490,3,錦江町,7923,8987,-1064,-11.8393234672,163.19,48.6,3442,3804,-362,-9.516298633
46491,3,南大隅町,7542,8815,-1273,-14.4412932501,213.57,35.3,3559,4005,-446,-11.1360799001
46492,3,肝付町,15664,17160,-1496,-8.7179487179,308.1,50.8,6974,7518,-544,-7.2359670125
46501,3,中種子町,8135,8696,-561,-6.4512419503,137.18,59.3,3741,3946,-205,-5.1951343132
46502,3,南種子町,5745,6218,-473,-7.6069475716,110.36,52.1,2727,2834,-107,-3.7755822159
46505,3,屋久島町,12913,13589,-676,-4.9746118184,540.48,23.9,6133,6248,-115,-1.8405889885
46523,3,大和村,1530,1765,-235,-13.3144475921,88.26,17.3,709,831,-122,-14.6811070999
46524,3,宇検村,1722,1932,-210,-10.8695652174,103.07,16.7,866,935,-69,-7.3796791444
46525,3,瀬戸内町,9042,9874,-832,-8.4261697387,239.65,37.7,4413,4677,-264,-5.6446440026
46527,3,龍郷町,5806,6078,-272,-4.4751563014,81.82,71,2414,2468,-54,-2.188006483
46529,3,喜界町,7212,8169,-957,-11.7150201983,56.82,126.9,3363,3634,-271,-7.4573472757
46530,3,徳之島町,11160,12090,-930,-7.6923076923,104.92,106.4,4960,5230,-270,-5.1625239006
46531,3,天城町,5975,6653,-678,-10.1908913272,80.4,74.3,2623,2841,-218,-7.6733544527
46532,3,伊仙町,6362,6844,-482,-7.0426651081,62.71,101.5,2885,3035,-150,-4.942339374
46533,3,和泊町,6783,7114,-331,-4.6527973011,40.39,167.9,2909,2909,0,0
46534,3,知名町,6213,6806,-593,-8.712900382,53.3,116.6,2692,2862,-170,-5.9399021663
46535,3,与論町,5186,5327,-141,-2.6468931857,20.58,252,2056,2007,49,2.4414549078
47201,2,那覇市,319435,315954,3481,1.1017426587,39.57,8072.7,135532,129512,6020,4.6482179258
47205,2,宜野湾市,96243,91928,4315,4.6938908711,19.8,4860.8,39333,36361,2972,8.1735925855
47207,2,石垣市,47564,46922,642,1.3682281233,229.34,207.4,20514,19212,1302,6.777014366
47208,2,浦添市,114232,110351,3881,3.5169595201,19.48,5864.1,44041,40927,3114,7.6086690938
47209,2,名護市,61674,60231,1443,2.3957762614,210.9,292.4,26142,24277,1865,7.6821683075
47210,2,糸満市,58547,57320,1227,2.1406140963,46.62,1255.8,20647,19249,1398,7.2627149462
47211,2,沖縄市,139279,130249,9030,6.9328747246,49.72,2801.3,53325,47999,5326,11.0960645013
47212,2,豊見城市,61119,57261,3858,6.7375700739,19.6,3118.3,21780,19332,2448,12.6629422719
47213,2,うるま市,118898,116979,1919,1.6404653827,87.01,1366.5,42378,38344,4034,10.5205508033
47214,2,宮古島市,51186,52039,-853,-1.6391552489,204.2,250.7,21977,21196,781,3.6846574825
47215,2,南城市,42016,39758,2258,5.6793601288,49.94,841.3,14295,12676,1619,12.7721678763
47301,3,国頭村,4908,5188,-280,-5.3970701619,194.8,25.2,2061,2114,-53,-2.5070955535
47302,3,大宜味村,3060,3221,-161,-4.9984476871,63.55,48.2,1262,1267,-5,-0.3946329913
47303,3,東村,1720,1794,-74,-4.1248606466,81.88,21,748,691,57,8.2489146165
47306,3,今帰仁村,9531,9257,274,2.959922221,39.93,238.7,3490,3368,122,3.622327791
47308,3,本部町,13536,13870,-334,-2.408074982,54.35,249.1,5237,5049,188,3.7235096059
47311,3,恩納村,10652,10144,508,5.0078864353,50.82,209.6,4065,3801,264,6.9455406472
47313,3,宜野座村,5597,5331,266,4.9896829863,31.3,178.8,2003,1823,180,9.873834339
47314,3,金武町,11232,11066,166,1.5000903669,37.84,296.8,4611,4373,238,5.4424879945
47315,3,伊江村,4260,4737,-477,-10.0696643445,22.78,187,1917,1915,2,0.1044386423
47324,3,読谷村,39504,38200,1304,3.4136125654,35.28,1119.7,13658,12422,1236,9.9500885526
47325,3,嘉手納町,13685,13827,-142,-1.026976206,15.12,905.1,5069,4937,132,2.6736884748
47326,3,北谷町,28308,27264,1044,3.8292253521,13.93,2032.2,10724,9903,821,8.2904170453
47327,3,北中城村,16148,15951,197,1.2350322864,11.54,1399.3,5541,5220,321,6.1494252874
47328,3,中城村,19454,17680,1774,10.0339366516,15.53,1252.7,7209,6268,941,15.0127632419
47329,3,西原町,34508,34766,-258,-0.7421043548,15.9,2170.3,12641,12118,523,4.3158937118
47348,3,与那原町,18410,16318,2092,12.8201985537,5.18,3554.1,7003,5805,1198,20.6373815676
47350,3,南風原町,37502,35244,2258,6.4067642719,10.76,3485.3,12763,11254,1509,13.4085658433
47353,3,渡嘉敷村,730,760,-30,-3.9473684211,19.23,38,417,429,-12,-2.7972027972
47354,3,座間味村,870,865,5,0.5780346821,16.74,52,453,459,-6,-1.3071895425
47355,3,粟国村,759,863,-104,-12.0509849363,7.65,99.2,429,379,50,13.1926121372
47356,3,渡名喜村,430,452,-22,-4.8672566372,3.87,111.1,267,246,21,8.5365853659
47357,3,南大東村,1329,1442,-113,-7.8363384189,30.53,43.5,686,713,-27,-3.7868162693
47358,3,北大東村,629,665,-36,-5.4135338346,13.09,48.1,333,378,-45,-11.9047619048
47359,3,伊平屋村,1238,1385,-147,-10.6137184116,21.82,56.7,516,523,-7,-1.3384321224
47360,3,伊是名村,1517,1589,-72,-4.5311516677,15.42,98.4,695,699,-4,-0.5722460658
47361,3,久米島町,7755,8519,-764,-8.9681887545,63.65,121.8,3365,3601,-236,-6.5537350736
47362,3,八重瀬町,29066,26681,2385,8.9389453169,26.96,1078.1,9625,8139,1486,18.257771225
47375,3,多良間村,1194,1231,-37,-3.0056864338,21.99,54.3,470,499,-29,-5.8116232465
47381,3,竹富町,3998,3859,139,3.6019694221,334.39,12,2122,2000,122,6.1
47382,3,与那国町,1843,1657,186,11.2251056126,28.96,63.6,1080,713,367,51.4726507714
